State,Start.date,End.date,Entry Date Time,Biden,Trump,Biden_Margin,Outcome
TX,10/15/2020,10/18/2020,10/19/2020 22:55,47,46,1,1
AL,10/11/2020,10/14/2020,10/19/2020 19:30,38,55,-17,0
WA,10/14/2020,10/15/2020,10/19/2020 19:30,60,37,23,1
WI,10/13/2020,10/19/2020,10/19/2020 17:29,51,43,8,1
PA,10/13/2020,10/19/2020,10/19/2020 17:29,49,45,4,1
--,10/16/2020,10/18/2020,10/19/2020 15:00,52,43,9,1
MI,10/18/2020,10/18/2020,10/19/2020 15:00,51,41,10,1
--,10/16/2020,10/18/2020,10/19/2020 15:00,51,40,11,1
--,10/14/2020,10/18/2020,10/19/2020 15:00,50,44,6,1
--,10/5/2020,10/18/2020,10/19/2020 15:00,52,42,10,1
--,10/15/2020,10/17/2020,10/19/2020 15:00,51,43,8,1
WI,10/5/2020,10/18/2020,10/19/2020 15:00,48,46,2,1
PA,10/5/2020,10/18/2020,10/19/2020 15:00,48,46,2,1
--,10/9/2020,10/12/2020,10/19/2020 15:00,55,39,16,1
VA,10/9/2020,10/11/2020,10/19/2020 15:00,51,42,9,1
CO,10/5/2020,10/9/2020,10/19/2020 15:00,47,38,9,1
VA,9/22/2020,9/25/2020,10/19/2020 15:00,52,41,11,1
--,9/9/2020,9/22/2020,10/19/2020 15:00,56,43,13,1
WI,10/13/2020,10/16/2020,10/18/2020 12:02,51,46,5,1
AZ,10/13/2020,10/16/2020,10/18/2020 12:02,50,47,3,1
MO,10/14/2020,10/15/2020,10/18/2020 9:00,45,51,-6,0
MI,10/11/2020,10/14/2020,10/16/2020 14:39,46,47,-1,0
AK,10/9/2020,10/14/2020,10/16/2020 14:39,39,45,-6,0
NJ,10/7/2020,10/13/2020,10/16/2020 14:39,56,36,20,1
FL,10/8/2020,10/12/2020,10/16/2020 14:39,48,45,3,1
--,10/8/2020,10/12/2020,10/16/2020 14:39,53,43,10,1
--,10/8/2020,10/12/2020,10/16/2020 14:39,51,36,15,1
--,10/7/2020,10/12/2020,10/16/2020 14:39,49,38,11,1
HI,10/2/2020,10/7/2020,10/16/2020 14:39,61,28,33,1
--,9/25/2020,10/8/2020,10/15/2020 14:44,48,35,13,1
PA,10/8/2020,10/11/2020,10/15/2020 14:44,52,45,7,1
MI,10/8/2020,10/11/2020,10/15/2020 14:44,52,43,9,1
WI,10/8/2020,10/11/2020,10/15/2020 14:44,53,45,8,1
OH,10/8/2020,10/11/2020,10/15/2020 14:44,47,50,-3,0
--,10/8/2020,10/13/2020,10/15/2020 14:44,54,43,11,1
CO,10/8/2020,10/13/2020,10/15/2020 14:18,54,49,5,1
SC,10/9/2020,10/15/2020,10/15/2020 12:15,41,49,-8,0
--,10/8/2020,10/13/2020,10/15/2020 12:15,54,42,12,1
MI,10/8/2020,10/13/2020,10/15/2020 12:15,48,42,6,1
ME,10/2/2020,10/6/2020,10/15/2020 12:15,50,40,10,1
--,10/5/2020,10/12/2020,10/15/2020 12:15,53,43,10,1
AZ,10/9/2020,10/13/2020,10/15/2020 12:15,50,45,5,1
VA,9/30/2020,10/12/2020,10/15/2020 8:26,53,38,15,1
IA,10/8/2020,10/11/2020,10/15/2020 8:26,47,48,-1,0
AZ,10/4/2020,10/8/2020,10/15/2020 8:26,49,45,4,1
NC,10/11/2020,10/14/20202,10/15/2020 8:26,51,46,5,1
CO,10/11/2020,10/14/20202,10/15/2020 8:26,54,42,12,1
VA,10/11/2020,10/14/20202,10/15/2020 8:26,55,42,13,1
--,10/9/2020,10/12/2020,10/15/2020 1:26,53,42,11,1
FL,10/7/2020,10/12/2020,10/14/2020 23:19,47,40,7,1
--,10/9/2020,10/13/2020,10/14/2020 23:19,51,41,10,1
SC,10/8/2020,10/11/2020,10/14/2020 23:19,43,52,-9,0
GA,10/8/2020,10/11/2020,10/14/2020 23:19,46,46,0,0
AZ,10/7/2020,10/14/2020,10/14/2020 17:19,50,46,4,1
FL,10/7/2020,10/14/2020,10/14/2020 17:19,49,47,2,1
WI,10/10/2020,10/13/2020,10/14/2020 15:17,53,43,10,1
MN,10/10/2020,10/13/2020,10/14/2020 15:17,52,41,11,1
IA,10/10/2020,10/13/2020,10/14/2020 15:17,44,50,-6,0
--,10/10/2020,10/10/2020,10/14/2020 15:17,49,41,8,1
IN,10/8/2020,10/13/2020,10/14/2020 15:17,42,49,-7,0
GA,10/8/2020,10/12/2020,10/14/2020 14:17,51,44,7,1
OH,10/8/2020,10/12/2020,10/14/2020 14:17,48,47,1,1
NC,10/9/2020,10/13/2020,10/14/2020 13:19,46,42,4,1
PA,10/7/2020,10/12/2020,10/14/2020 12:33,49,43,6,1
LA,10/4/2020,10/6/2020,10/14/2020 12:33,36,54,-18,0
MT,9/14/2020,10/2/2020,10/14/2020 12:33,44,51,-7,0
GA,10/8/2020,10/12/2020,10/14/2020 12:33,48,46,2,1
FL,10/11/2020,10/12/2020,10/14/2020 12:33,49,47,2,1
FL,10/11/2020,10/13/2020,10/14/2020 12:33,46,48,-2,0
--,10/11/2020,10/13/2020,10/14/2020 8:33,52,42,10,1
NH,10/8/2020,10/12/2020,10/14/2020 8:33,51,41,10,1
MI,10/8/2020,10/12/2020,10/14/2020 8:33,48,39,9,1
FL,10/4/2020,10/8/2020,10/13/2020 19:41,48,46,2,1
NC,10/7/2020,10/11/2020,10/13/2020 19:41,47,45,2,1
NC,10/8/2020,10/11/2020,10/13/2020 17:41,50,45,5,1
NC,10/7/2020,10/13/2020,10/13/2020 17:41,48,48,0,1
MI,10/7/2020,10/13/2020,10/13/2020 17:41,51,44,7,1
NH,10/9/2020,10/12/2020,10/13/2020 17:41,55,43,12,1
WV,10/1/2020,10/6/2020,10/13/2020 17:41,39,53,-14,0
NC,10/8/2020,10/11/2020,10/13/2020 11:18,50,47,3,1
NV,10/7/2020,10/11/2020,10/13/2020 11:18,44,42,2,1
PA,10/10/2020,10/12/2020,10/13/2020 11:18,47,45,2,1
MO,9/24/2020,10/7/2020,10/13/2020 11:18,43,52,-9,0
--,10/8/2020,10/12/2020,10/13/2020 11:18,57,40,17,1
--,10/9/2020,10/11/2020,10/13/2020 8:38,51,43,8,1
WI,10/2/2020,10/11/2020,10/13/2020 8:38,51,44,7,1
TX,10/2/2020,10/11/2020,10/13/2020 8:38,47,49,-2,0
SC,10/2/2020,10/11/2020,10/13/2020 8:38,42,54,-12,0
PA,10/2/2020,10/11/2020,10/13/2020 8:38,52,44,8,1
OH,10/2/2020,10/11/2020,10/13/2020 8:38,46,49,-3,0
NC,10/2/2020,10/11/2020,10/13/2020 8:38,50,46,4,1
MN,10/2/2020,10/11/2020,10/13/2020 8:38,50,44,6,1
MI,10/2/2020,10/11/2020,10/13/2020 8:38,51,44,7,1
GA,10/2/2020,10/11/2020,10/13/2020 8:38,47,49,-2,0
FL,10/2/2020,10/11/2020,10/13/2020 8:38,51,46,5,1
CO,10/2/2020,10/11/2020,10/13/2020 8:38,54,40,14,1
AZ,10/2/2020,10/11/2020,10/13/2020 8:38,49,46,3,1
FL,10/9/2020,10/10/2020,10/13/2020 8:38,51,47,4,1
WA,10/8/2020,10/12/2020,10/12/2020 23:30,55,34,21,1
PA,10/6/2020,10/11/2020,10/12/2020 19:30,51,44,7,1
WI,10/6/2020,10/11/2020,10/12/2020 19:30,51,44,7,1
--,10/9/2020,10/11/2020,10/12/2020 19:30,51,43,8,1
--,10/8/2020,10/10/2020,10/12/2020 14:45,51,43,8,1
WI,10/8/2020,10/11/2020,10/12/2020 14:00,51,41,10,1
MI,10/6/2020,10/11/2020,10/12/2020 14:00,48,40,8,1
PA,10/5/2020,10/9/2020,10/12/2020 14:00,51,46,5,1
MT,10/9/2020,10/1/2020,10/12/2020 9:00,48,52,-4,0
--,10/7/2020,10/11/2020,10/12/2020 9:00,52,43,9,1
--,9/29/2020,10/11/2020,10/12/2020 9:00,54,41,13,1
IA,10/6/2020,10/9/2020,10/11/2020 12:00,49,49,0,1
NV,10/6/2020,10/9/2020,10/11/2020 12:00,52,46,6,1
MI,10/6/2020,10/9/2020,10/11/2020 12:00,52,46,6,1
WI,9/30/2020,108/2020,10/11/2020 9:00,49,43,6,1
PA,9/30/2020,108/2020,10/11/2020 9:00,50,45,5,1
OH,9/30/2020,108/2020,10/11/2020 9:00,45,47,-2,0
MI,9/30/2020,108/2020,10/11/2020 9:00,50,43,7,1
GA,10/8/2020,10/9/2020,10/11/2020 9:00,47,46,1,1
GA,10/7/2020,10/7/2020,10/11/2020 9:00,47,49,-2,0
--,10/6/2020,10/9/2020,10/11/2020 9:00,54,42,12,1
NJ,9/30/2020,10/5/2020,10/9/2020 15:08,53,38,15,1
WI,10/4/2020,10/6/2020,10/9/2020 15:08,51,41,10,1
AZ,10/4/2020,10/6/2020,10/9/2020 15:08,49,43,6,1
MI,10/4/2020,10/6/2020,10/9/2020 15:08,50,42,8,1
PA,10/4/2020,10/6/2020,10/9/2020 15:08,49,42,7,1
FL,10/4/2020,10/6/2020,10/9/2020 15:08,49,44,5,1
NC,10/4/2020,10/6/2020,10/9/2020 15:08,49,44,5,1
AZ,10/6/2020,10/8/2020,10/9/2020 12:08,44,48,-4,0
--,10/6/2020,10/8/2020,10/9/2020 12:08,53,41,12,1
--,10/2/2020,10/5/2020,10/9/2020 10:08,52,44,8,1
GA,9/27/2020,10/6/2020,10/9/2020 8:08,46,48,-2,0
--,9/30/2020,10/5/2020,10/9/2020 8:08,52,42,10,1
TX,9/25/2020,10/4/2020,10/9/2020 8:08,45,50,-5,0
NH,10/1/2020,10/4/2020,10/8/2020 16:32,53,41,12,1
TX,10/7/2020,10/8/2020,10/8/2020 16:32,50,49,1,1
--,10/6/2020,10/6/2020,10/8/2020 10:32,56,41,15,1
MD,9/30/2020,10/4/2020,10/8/2020 10:32,61,30,31,1
SC,9/24/2020,9/28/2020,10/8/2020 10:32,44,49,-5,0
FL,9/27/2020,10/2/2020,10/7/2020 20:10,50,44,6,1
--,9/27/2020,10/2/2020,10/7/2020 20:10,52,38,14,1
TX,9/30/2020,10/5/2020,10/7/2020 20:10,47,45,2,1
NC,9/30/2020,10/5/2020,10/7/2020 20:10,51,44,7,1
MT,9/30/2020,10/5/2020,10/7/2020 20:10,43,49,-6,0
MN,10/1/2020,10/6/2020,10/7/2020 20:10,47,40,7,1
--,10/3/2020,10/6/2020,10/7/2020 20:10,53,43,10,1
AZ,9/29/2020,10/7/2020,10/7/2020 14:52,48,46,2,1
FL,9/29/2020,10/7/2020,10/7/2020 14:52,49,45,4,1
FL,10/1/2020,10/5/2020,10/7/2020 14:18,51,40,11,1
PA,10/1/2020,10/5/2020,10/7/2020 14:18,54,41,13,1
IA,10/1/2020,10/5/2020,10/7/2020 14:18,50,45,5,1
WI,9/30/2020,10/4/2020,10/7/2020 13:18,46,41,5,1
NV,10/2/2020,10/6/2020,10/7/2020 13:18,48,42,6,1
OH,10/2/2020,10/6/2020,10/7/2020 13:18,45,44,1,1
AZ,10/3/2020,10/5/2020,10/7/2020 12:50,48,43,5,1
MO,9/28/2020,10/2/2020,10/7/2020 11:06,48,50,-2,0
TX,10/3/2020,10/6/2020,10/7/2020 8:55,48,48,0,1
IA,10/3/2020,10/6/2020,10/7/2020 8:55,48,47,1,1
MD,9/29/2020,10/1/2020,10/7/2020 8:55,61,32,29,1
WV,9/29/2020,9/30/2020,10/7/2020 8:55,38,56,-18,0
--,10/4/2020,10/6/2020,10/7/2020 8:55,51,42,9,1
--,9/30/2020,10/4/2020,10/6/2020 16:38,51,37,14,1
AK,9/25/2020,10/4/2020,10/6/2020 16:38,46,50,-4,0
--,10/2/2020,10/6/2020,10/6/2020 16:38,52,40,12,1
NC,9/29/2020,10/6/2020,10/6/2020 15:38,47,47,0,1
MI,9/29/2020,10/6/2020,10/6/2020 15:38,51,43,8,1
PA,9/29/2020,10/5/2020,10/6/2020 15:38,50,45,5,1
WI,9/29/2020,10/5/2020,10/6/2020 15:38,50,44,6,1
ME,9/25/2020,10/4/2020,10/6/2020 15:38,51,40,11,1
NC,10/2/2020,10/4/2020,10/6/2020 15:38,50,47,3,1
WI,10/2/2020,10/4/2020,10/6/2020 13:38,51,44,7,1
PA,10/2/2020,10/4/2020,10/6/2020 13:38,50,46,4,1
NC,10/2/2020,10/4/2020,10/6/2020 13:38,49,47,2,1
MI,10/2/2020,10/4/2020,10/6/2020 13:38,51,43,8,1
FL,10/2/2020,10/4/2020,10/6/2020 13:38,50,46,4,1
AZ,10/2/2020,10/4/2020,10/6/2020 13:38,51,45,6,1
--,10/1/2020,10/4/2020,10/6/2020 13:38,53,43,10,1
--,10/3/2020,10/4/2020,10/6/2020 13:38,50,42,8,1
PA,9/30/2020,10/4/2020,10/6/2020 11:01,54,44,10,1
FL,10/1/2020,10/4/2020,10/6/2020 8:01,51,45,6,1
FL,10/1/2020,10/4/2020,10/6/2020 8:01,45,45,0,0
NM,9/30/2020,10/1/2020,10/6/2020 8:01,53,39,14,1
AZ,9/24/2020,9/29/2020,10/6/2020 8:01,49,45,4,1
--,10/1/2020,10/4/2020,10/6/2020 8:01,57,41,16,1
UT,9/26/2020,10/4/2020,10/5/2020 14:01,40,50,-10,0
NC,10/4/2020,10/5/2020,10/5/2020 14:01,50,46,4,1
--,10/2/2020,10/3/2020,10/5/2020 13:01,52,43,9,1
OH,10/1/2020,10/3/2020,10/5/2020 13:01,44,48,-4,0
AZ,10/1/2020,10/3/2020,10/5/2020 13:01,49,41,8,1
DE,9/21/2020,9/27/2020,10/5/2020 13:01,54,33,21,1
--,9/8/2020,9/10/2020,10/5/2020 13:01,53,45,8,1
--,9/21/2020,10/4/2020,10/5/2020 8:42,53,42,11,1
--,10/2/2020,10/3/2020,10/4/2020 15:12,51,43,8,1
--,10/1/2020,10/2/2020,10/4/2020 15:12,48,40,8,1
OH,9/30/2020,10/2/2020,10/4/2020 10:49,47,47,0,0
PA,9/30/2020,10/2/2020,10/4/2020 10:49,51,44,7,1
--,9/30/2020,10/1/2020,10/4/2020 9:18,53,39,14,1
--,10/2/2020,10/3/2020,10/4/2020 9:18,51,41,10,1
PA,9/30/2020,10/1/2020,10/3/2020 12:12,49,42,7,1
FL,9/30/2020,10/1/2020,10/3/2020 12:12,47,42,5,1
MO,9/30/2020,10/1/2020,10/3/2020 12:12,46,51,-5,0
--,9/29/2020,10/1/2020,10/2/2020 16:39,50,41,9,1
--,9/30/2020,10/1/2020,10/2/2020 16:39,51,41,10,1
TX,9/24/2020,9/27/2020,10/2/2020 16:39,47,49,-2,0
OH,9/24/2020,9/27/2020,10/2/2020 16:39,47,49,-2,0
NC,9/24/2020,9/27/2020,10/2/2020 16:39,49,47,2,1
IA,9/24/2020,9/27/2020,10/2/2020 16:39,47,49,-2,0
GA,9/24/2020,9/27/2020,10/2/2020 16:39,50,47,3,1
--,9/30/2020,10/1/2020,10/2/2020 13:39,49,46,3,1
MI,9/30/2020,10/1/2020,10/2/2020 13:39,50,44,6,1
WI,9/23/2020,9/25/2020,10/2/2020 13:39,48,43,5,1
MI,9/23/2020,9/25/2020,10/2/2020 13:39,51,42,9,1
NC,9/23/2020,9/25/2020,10/2/2020 13:39,47,45,2,1
AZ,9/23/2020,9/25/2020,10/2/2020 13:39,47,44,3,1
PA,9/23/2020,9/25/2020,10/2/2020 13:39,50,44,6,1
FL,9/23/2020,9/25/2020,10/2/2020 13:39,48,43,5,1
AZ,9/26/2020,9/30/2020,10/2/2020 13:39,50,46,4,1
NY,9/27/2020,9/29/2020,10/2/2020 13:39,51,29,22,1
--,9/26/2020,9/28/2020,10/2/2020 13:39,53,43,10,1
--,9/14/2020,9/22/2020,10/1/2020 20:28,53,42,11,1
GA,9/30/2020,9/30/2020,10/1/2020 20:28,47,45,2,1
--,9/29/2020,9/30/2020,10/1/2020 14:03,54,41,13,1
NC,9/22/2020,9/28/2020,10/1/2020 14:03,50,47,3,1
SC,9/24/2020,9/28/2020,10/1/2020 11:09,43,47,-4,0
ME,9/24/2020,9/28/2020,10/1/2020 11:09,53,39,14,1
IA,9/24/2020,9/28/2020,10/1/2020 11:09,44,47,-3,0
AZ,9/24/2020,9/28/2020,10/1/2020 11:09,49,45,4,1
PA,8/26/2020,9/1/2020,10/1/2020 11:09,50,44,6,1
OH,8/26/2020,9/1/2020,10/1/2020 11:09,48,46,2,1
OR,9/26/2020,9/29/2020,9/30/2020 19:30,56,39,17,1
--,9/25/2020,9/29/2020,9/30/2020 18:30,51,42,9,1
IA,9/23/2020,9/26/2020,9/30/2020 17:52,48,46,2,1
KS,9/26/2020,9/29/2020,9/30/2020 17:28,42,52,-10,0
SC,9/23/2020,9/27/2020,9/30/2020 14:12,47,48,-1,0
--,9/27/2020,9/30/2020,9/30/2020 14:12,50,42,8,1
--,7/31/2020,8/11/2020,9/30/2020 13:30,48,37,11,1
CA,9/26/2020,9/28/2020,9/30/2020 13:30,59,32,27,1
NH,9/24/2020,9/26/2020,9/30/2020 13:30,53,44,9,1
--,9/26/2020,9/27/2020,9/29/2020 21:02,50,40,10,1
GA,9/26/2020,9/29/2020,9/29/2020 15:55,50,47,3,1
ND,9/12/2020,9/16/2020,9/29/2020 14:10,37,56,-19,0
TX,9/18/2020,9/25/2020,9/29/2020 14:10,46,49,-3,0
NC,9/18/2020,9/25/2020,9/29/2020 14:10,47,47,0,1
NH,9/18/2020,9/25/2020,9/29/2020 14:10,52,44,8,1
GA,9/23/2020,9/27/2020,9/29/2020 14:10,50,47,3,1
--,9/25/2020,9/27/2020,9/29/2020 11:36,51,44,7,1
--,9/14/2020,9/23/2020,9/29/2020 8:55,51,41,10,1
PA,9/21/2020,9/26/2020,9/29/2020 0:02,54,45,9,1
AK,9/20/2020,9/23/2020,9/28/2020 17:26,46,47,-1,0
PA,9/25/2020,9/27/2020,9/28/2020 17:26,49,40,9,1
WI,9/22/2020,9/25/2020,9/28/2020 16:49,48,45,3,1
--,9/24/2020,9/27/2020,9/28/2020 14:13,50,45,5,1
NC,9/18/2020,9/22/2020,9/28/2020 13:04,46,45,1,1
TX,9/25/2020,9/26/2020,9/28/2020 11:24,48,48,0,1
--,9/19/2020,9/25/2020,9/28/2020 11:24,50,41,9,1
NV,9/10/2020,9/25/2020,9/28/2020 11:24,46,41,5,1
CA,9/19/2020,9/21/2020,9/27/2020 18:25,62,28,34,1
--,9/13/2020,9/26/2020,9/27/2020 16:40,51,42,9,1
SC,9/22/2020,9/25/2020,9/27/2020 16:40,42,52,-10,0
NC,9/22/2020,9/25/2020,9/27/2020 16:40,48,46,2,1
GA,9/22/2020,9/25/2020,9/27/2020 16:40,46,47,-1,0
--,9/22/2020,9/24/2020,9/27/2020 16:40,49,41,8,1
--,9/21/2020,9/24/2020,9/27/2020 16:40,49,43,6,1
WI,9/20/2020,9/24/2020,9/27/2020 16:40,54,44,10,1
MI,9/19/2020,9/23/2020,9/27/2020 16:40,52,44,8,1
MN,9/21/2020,9/23/2020,9/26/2020 15:18,48,42,6,1
--,9/22/2020,9/24/2020,9/25/2020 18:22,50,41,9,1
--,9/18/2020,9/22/2020,9/25/2020 18:22,50,42,8,1
WI,9/17/2020,9/19/2020,9/25/2020 18:22,51,44,7,1
PA,9/17/2020,9/19/2020,9/25/2020 18:22,53,42,11,1
MI,9/17/2020,9/19/2020,9/25/2020 18:22,50,45,5,1
FL,9/17/2020,9/19/2020,9/25/2020 18:22,51,45,6,1
AZ,9/17/2020,9/19/2020,9/25/2020 18:22,53,42,11,1
--,9/22/2020,9/23/2020,9/25/2020 18:22,50,41,9,1
NV,9/15/2020,9/21/2020,9/25/2020 13:19,47,43,4,1
CA,9/5/2020,9/15/2020,9/25/2020 13:19,67,28,39,1
MD,9/4/2020,9/11/2020,9/25/2020 13:19,62,30,32,1
TX,9/15/2020,9/22/2020,9/25/2020 13:19,45,46,-1,0
FL,9/15/2020,9/22/2020,9/25/2020 13:19,46,43,3,1
AZ,9/15/2020,9/22/2020,9/25/2020 13:19,45,46,-1,0
PA,9/18/2020,9/21/2020,9/25/2020 13:19,48,46,2,1
ME,9/17/2020,9/23/2020,9/25/2020 13:19,50,39,11,1
MN,9/20/2020,9/24/2020,9/25/2020 13:19,47,40,7,1
PA,9/20/2020,9/23/2020,9/24/2020 19:18,51,44,7,1
OH,9/20/2020,9/23/2020,9/24/2020 19:18,50,45,5,1
NV,9/20/2020,9/23/2020,9/24/2020 19:18,52,41,11,1
--,9/21/2020,9/23/2020,9/24/2020 14:18,49,44,5,1
TX,9/17/2020,9/21/2020,9/24/2020 14:18,45,50,-5,0
OH,9/17/2020,9/21/2020,9/24/2020 14:18,48,47,1,1
MI,9/14/2020,9/19/2020,9/24/2020 13:57,50,44,6,1
KY,9/14/2020,9/19/2020,9/24/2020 13:57,38,56,-18,0
KS,9/14/2020,9/19/2020,9/24/2020 13:57,45,49,-4,0
GA,9/14/2020,9/19/2020,9/24/2020 13:57,46,46,0,1
AZ,9/14/2020,9/17/2020,9/24/2020 13:57,49,47,2,1
MI,9/20/2020,9/22/2020,9/24/2020 12:03,46,47,-1,0
IA,9/18/2020,9/22/2020,9/24/2020 12:03,46,49,-3,0
VA,9/9/2020,9/21/2020,9/24/2020 8:55,48,43,5,1
--,9/17/2020,9/21/2020,9/24/2020 8:55,53,42,11,1
WI,9/10/2020,9/21/2020,9/24/2020 8:55,50,46,4,1
PA,9/10/2020,9/21/2020,9/24/2020 8:55,49,45,4,1
MI,9/10/2020,9/21/2020,9/24/2020 8:55,51,45,6,1
TX,9/16/2020,9/22/2020,9/24/2020 8:55,43,46,-3,0
IA,9/16/2020,9/22/2020,9/24/2020 8:55,45,42,3,1
GA,9/16/2020,9/22/2020,9/24/2020 8:55,45,45,0,1
PA,9/14/2020,9/20/2020,9/23/2020 18:55,48,42,6,1
PA,9/15/2020,9/17/2020,9/23/2020 18:55,50,45,5,1
--,8/25/2020,9/6/2020,9/23/2020 18:55,52,42,10,1
AZ,9/11/2020,9/17/2020,9/23/2020 16:23,47,46,1,1
FL,9/11/2020,9/16/2020,9/23/2020 16:23,47,47,0,0
WI,9/8/2020,9/22/2020,9/23/2020 16:23,50,41,9,1
PA,9/8/2020,9/22/2020,9/23/2020 16:23,47,45,2,1
MI,9/8/2020,9/22/2020,9/23/2020 16:23,50,42,8,1
OH,9/8/2020,9/22/2020,9/23/2020 16:23,45,44,1,1
NC,9/17/2020,9/20/2020,9/23/2020 15:28,44,45,-1,0
--,9/17/2020,9/21/2020,9/23/2020 14:10,52,42,10,1
--,9/8/2020,9/15/2020,9/23/2020 13:30,50,40,10,1
GA,9/17/2020,9/21/2020,9/23/2020 11:23,46,49,-3,0
FL,9/21/2020,9/22/2020,9/23/2020 11:23,50,47,3,1
--,9/20/2020,9/22/2020,9/23/2020 11:23,49,42,7,1
WI,9/18/2020,9/20/2020,9/23/2020 11:23,51,42,9,1
PA,9/18/2020,9/20/2020,9/23/2020 11:23,49,45,4,1
NC,9/18/2020,9/20/2020,9/23/2020 11:23,48,46,2,1
MI,9/18/2020,9/20/2020,9/23/2020 11:23,51,43,8,1
FL,9/18/2020,9/20/2020,9/23/2020 11:23,49,46,3,1
AZ,9/18/2020,9/20/2020,9/23/2020 11:23,49,43,6,1
--,9/18/2020,9/20/2020,9/23/2020 11:23,51,42,9,1
FL,9/15/2020,9/20/2020,9/23/2020 11:23,47,51,-4,0
AZ,9/15/2020,9/20/2020,9/23/2020 11:23,48,49,-1,0
--,9/8/2020,9/9/2020,9/23/2020 11:23,52,41,11,1
NC,9/11/2020,9/16/2020,9/22/2020 16:25,47,47,0,1
MI,9/11/2020,9/16/2020,9/22/2020 16:25,49,44,5,1
WA,9/8/2020,9/14/2020,9/22/2020 11:33,58,36,22,1
MI,9/14/2020,9/19/2020,9/22/2020 11:33,46,41,5,1
VT,9/3/2020,9/15/2020,9/22/2020 8:53,56,32,24,1
SC,9/11/2020,9/20/2020,9/22/2020 8:53,44,50,-6,0
IA,9/14/2020,9/17/2020,9/22/2020 8:53,47,47,0,1
GA,9/11/2020,9/20/2020,9/22/2020 8:53,47,47,0,1
WI,9/11/2020,9/16/2020,9/21/2020 19:32,48,43,5,1
PA,9/11/2020,9/16/2020,9/21/2020 19:32,49,46,3,1
--,9/3/2020,9/7/2020,9/21/2020 19:32,51,43,8,1
--,9/16/2020,9/19/2020,9/21/2020 11:55,50,44,6,1
ME,9/17/2020,9/20/2020,9/21/2020 11:54,51,39,12,1
GA,9/14/2020,9/16/2020,9/21/2020 11:54,49,46,3,1
--,9/18/2020,9/20/2020,9/21/2020 8:55,48,41,7,1
--,9/14/2020,9/20/2020,9/21/2020 8:55,51,42,9,1
LA,9/2/2020,9/5/2020,9/21/2020 8:50,42,48,-6,0
MS,8/28/2020,8/30/2020,9/21/2020 8:50,40,50,-10,0
TX,8/20/2020,8/25/2020,9/21/2020 8:50,48,44,4,1
AL,8/17/2020,8/18/2020,9/21/2020 8:50,44,48,-4,0
FL,8/11/2020,8/15/2020,9/21/2020 8:50,46,44,2,1
TX,9/15/2020,9/18/2020,9/20/2020 14:45,46,48,-2,0
FL,9/15/2020,9/18/2020,9/20/2020 14:45,48,46,2,1
PA,9/15/2020,9/17/2020,9/20/2020 14:45,47,45,2,1
MN,9/12/2020,9/17/2020,9/20/2020 14:45,51,42,9,1
MT,9/14/2020,9/16/2020,9/20/2020 14:45,42,49,-7,0
--,9/13/2020,9/16/2020,9/20/2020 14:45,51,43,8,1
GA,9/12/2020,9/18/2020,9/20/2020 14:45,45,46,-1,0
MO,9/16/2020,9/17/2020,9/19/2020 8:50,45,53,-8,0
--,9/16/2020,9/17/2020,9/19/2020 8:50,49,42,7,1
PA,9/8/2020,9/11/2020,9/19/2020 8:50,48,43,5,1
--,9/15/2020,9/17/2020,9/18/2020 15:59,47,41,6,1
--,9/15/2020,9/17/2020,9/18/2020 14:59,51,42,9,1
WI,9/12/2020,9/16/2020,9/18/2020 14:20,47,41,6,1
AZ,9/12/2020,9/16/2020,9/18/2020 14:20,47,42,5,1
NC,9/12/2020,9/16/2020,9/18/2020 14:20,47,45,2,1
PA,9/12/2020,9/16/2020,9/18/2020 14:20,49,44,5,1
MI,9/12/2020,9/16/2020,9/18/2020 14:20,49,39,10,1
FL,9/12/2020,9/16/2020,9/18/2020 14:20,47,44,3,1
--,9/10/2020,9/14/2020,9/18/2020 13:46,53,42,11,1
WI,9/11/2020,9/15/2020,9/18/2020 13:43,51,44,7,1
PA,9/11/2020,9/15/2020,9/18/2020 13:43,52,45,7,1
OH,9/11/2020,9/15/2020,9/18/2020 13:43,45,48,-3,0
MI,9/11/2020,9/15/2020,9/18/2020 13:43,53,42,11,1
--,9/15/2020,9/15/2020,9/18/2020 13:42,53,42,11,1
--,9/11/2020,9/16/2020,9/18/2020 13:41,52,43,9,1
NC,9/11/2020,9/16/2020,9/18/2020 8:50,45,44,1,1
ME,9/11/2020,9/16/2020,9/18/2020 8:50,55,38,17,1
AZ,9/10/2020,9/15/2020,9/18/2020 8:50,49,40,9,1
MI,9/10/2020,9/15/2020,9/18/2020 8:50,48,40,8,1
AZ,9/11/2020,9/15/2020,9/17/2020 13:30,48,47,1,1
CA,9/4/2020,9/13/2020,9/17/2020 8:55,60,31,29,1
UT,9/7/2020,9/12/2020,9/17/2020 8:55,35,53,-18,0
NC,9/11/2020,9/14/2020,9/17/2020 8:55,46,43,3,1
NC,8/29/2020,9/13/2020,9/17/2020 8:55,45,43,2,1
FL,8/29/2020,9/13/2020,9/17/2020 8:55,43,42,1,1
AZ,8/29/2020,9/13/2020,9/17/2020 8:55,45,40,5,1
SC,9/10/2020,9/14/2020,9/16/2020 14:45,45,51,-6,0
ME,9/10/2020,9/14/2020,9/16/2020 14:45,59,38,21,1
KY,9/10/2020,9/14/2020,9/16/2020 14:45,38,58,-20,0
--,9/11/2020,9/15/2020,9/16/2020 10:52,50,41,9,1
CA,8/22/2020,8/24/2020,9/16/2020 8:55,61,31,30,1
--,9/13/2020,9/15/2020,9/16/2020 8:52,51,42,9,1
WI,9/8/2020,9/13/2020,9/16/2020 8:52,52,46,6,1
MN,9/8/2020,9/13/2020,9/16/2020 8:52,57,41,16,1
VA,8/28/2020,9/7/2020,9/15/2020 14:07,53,39,14,1
FL,9/10/2020,9/13/2020,9/15/2020 13:07,50,46,4,1
WI,9/9/2020,9/13/2020,9/15/2020 12:30,52,42,10,1
NC,9/9/2020,9/13/2020,9/15/2020 12:30,49,46,3,1
--,7/6/2020,7/28/2020,9/15/2020 9:38,48,34,14,1
FL,9/11/2020,9/12/2020,9/15/2020 9:36,50,50,0,1
MN,9/4/2020,9/13/2020,9/15/2020 9:35,48,44,4,1
--,9/11/2020,9/13/2020,9/15/2020 9:35,51,43,8,1
--,9/10/2020,9/12/2020,9/14/2020 16:45,48,43,5,1
NC,9/10/2020,9/13/2020,9/14/2020 16:45,47,47,0,1
NC,9/9/2020,9/11/2020,9/14/2020 16:45,46,48,-2,0
CO,8/28/2020,9/1/2020,9/14/2020 10:40,50,39,11,1
AZ,9/8/2020,9/10/2020,9/14/2020 9:14,52,42,10,1
--,9/6/2020,9/12/2020,9/13/2020 11:40,52,42,10,1
WI,9/3/2020,9/12/2020,9/13/2020 11:40,50,43,7,1
MN,9/9/2020,9/11/2020,9/13/2020 11:40,50,41,9,1
AZ,9/9/2020,9/11/2020,9/13/2020 11:40,47,44,3,1
--,9/7/2020,9/10/2020,9/13/2020 11:40,51,46,5,1
AZ,9/10/2020,9/11/2020,9/12/2020 8:00,50,48,2,1
NH,9/8/2020,9/10/2020,9/12/2020 8:00,45,42,3,1
WI,9/8/2020,9/10/2020,9/12/2020 8:00,48,43,5,1
NV,9/8/2020,9/10/2020,9/12/2020 8:00,46,42,4,1
MN,9/8/2020,9/10/2020,9/12/2020 8:00,50,41,9,1
--,9/9/2020,9/11/2020,9/11/2020 17:42,49,39,10,1
OR,9/3/2020,9/8/2020,9/11/2020 17:12,51,39,12,1
--,9/4/2020,9/10/2020,9/11/2020 12:39,51,42,9,1
IN,9/3/2020,9/7/2020,9/10/2020 22:40,30,53,-23,0
PA,9/3/2020,9/6/2020,9/10/2020 15:10,51,44,7,1
--,9/3/2020,9/8/2020,9/10/2020 11:15,51,44,7,1
FL,8/28/2020,9/8/2020,9/10/2020 10:08,48,46,2,1
AZ,8/28/2020,9/8/2020,9/10/2020 10:08,48,47,1,1
MI,8/28/2020,9/8/2020,9/10/2020 10:08,50,43,7,1
PA,8/28/2020,9/8/2020,9/10/2020 10:08,49,46,3,1
WI,8/28/2020,9/8/2020,9/10/2020 10:08,50,45,5,1
NC,8/28/2020,9/8/2020,9/10/2020 10:08,48,48,0,1
IA,8/30/2020,9/5/2020,9/10/2020 10:08,45,47,-2,0
GA,8/30/2020,9/5/2020,9/10/2020 10:08,47,46,1,1
CO,8/30/2020,9/5/2020,9/10/2020 10:08,50,40,10,1
ME,8/30/2020,9/5/2020,9/10/2020 10:08,54,40,14,1
MT,8/30/2020,9/5/2020,9/10/2020 10:08,43,50,-7,0
--,8/28/2020,9/3/2020,9/10/2020 9:08,48,43,5,1
--,9/7/2020,9/8/2020,9/9/2020 23:30,49,40,9,1
OK,9/2/2020,9/8/2020,9/9/2020 23:25,35,60,-25,0
MN,9/4/2020,9/7/2020,9/9/2020 18:37,49,40,9,1
--,8/31/2020,9/2/2020,9/9/2020 14:19,54,46,8,1
FL,9/7/2020,9/8/2020,9/9/2020 14:13,50,47,3,1
WI,8/30/2020,9/3/2020,9/9/2020 13:25,47,43,4,1
--,9/4/2020,9/6/2020,9/9/2020 10:05,49,41,8,1
--,9/6/2020,9/8/2020,9/9/2020 8:42,52,43,9,1
--,9/2/2020,9/8/2020,9/9/2020 8:26,52,40,12,1
PA,8/31/2020,9/7/2020,9/9/2020 8:25,53,44,9,1
TX,8/29/2020,9/7/2020,9/9/2020 8:22,46,46,0,1
PA,8/29/2020,9/7/2020,9/9/2020 8:22,50,45,5,1
OH,8/29/2020,9/7/2020,9/9/2020 8:22,45,50,-5,0
NC,8/29/2020,9/7/2020,9/9/2020 8:22,48,47,1,1
MN,8/29/2020,9/7/2020,9/9/2020 8:22,49,44,5,1
MI,8/29/2020,9/7/2020,9/9/2020 8:22,52,42,10,1
GA,8/29/2020,9/7/2020,9/9/2020 8:22,46,48,-2,0
FL,8/29/2020,9/7/2020,9/9/2020 8:22,50,45,5,1
CO,8/29/2020,9/7/2020,9/9/2020 8:22,49,43,6,1
AZ,8/29/2020,9/7/2020,9/9/2020 8:22,49,46,3,1
--,9/4/2020,9/6/2020,9/9/2020 8:19,49,43,6,1
WI,9/4/2020,9/6/2020,9/9/2020 8:19,50,44,6,1
PA,9/4/2020,9/6/2020,9/9/2020 8:19,50,46,4,1
NC,9/4/2020,9/6/2020,9/9/2020 8:19,49,47,2,1
MI,9/4/2020,9/6/2020,9/9/2020 8:19,49,43,6,1
FL,9/4/2020,9/6/2020,9/9/2020 8:19,49,46,3,1
AZ,9/4/2020,9/6/2020,9/9/2020 8:19,49,45,4,1
MI,9/1/2020,9/3/2020,9/8/2020 17:44,47,42,5,1
WI,8/21/2020,9/3/2020,9/8/2020 15:44,50,41,9,1
AZ,8/21/2020,9/3/2020,9/8/2020 15:44,48,43,5,1
PA,8/21/2020,9/3/2020,9/8/2020 15:44,48,43,5,1
NC,8/21/2020,9/3/2020,9/8/2020 15:44,43,44,-1,0
MI,8/21/2020,9/3/2020,9/8/2020 15:44,51,40,11,1
FL,8/21/2020,9/3/2020,9/8/2020 15:44,47,44,3,1
FL,8/26/2020,9/3/2020,9/8/2020 14:44,51,46,5,1
TX,8/1/2020,8/2/2020,9/8/2020 13:49,47,48,-1,0
FL,8/31/2020,9/6/2020,9/8/2020 13:15,48,48,0,1
MO,9/1/2020,9/3/2020,9/8/2020 12:52,44,49,-5,0
PA,8/28/2020,9/4/2020,9/8/2020 12:50,44,42,2,1
WI,8/28/2020,9/6/2020,9/7/2020 21:06,51,43,8,1
ID,8/29/2020,9/1/2020,9/7/2020 14:06,34,60,-26,0
CA,8/29/2020,9/1/2020,9/7/2020 14:06,56,39,17,1
--,8/31/2020,9/6/2020,9/7/2020 10:47,52,42,10,1
--,9/4/2020,9/6/2020,9/7/2020 8:22,50,44,6,1
WI,9/2/2020,9/4/2020,9/6/2020 10:36,50,44,6,1
--,9/2/2020,9/4/2020,9/6/2020 10:36,52,42,10,1
TX,8/28/2020,9/2/2020,9/6/2020 10:33,49,48,1,1
NM,8/26/2020,9/2/2020,9/6/2020 10:33,54,39,15,1
--,8/24/2020,8/28/2020,9/4/2020 18:41,50,37,13,1
MN,9/3/2020,9/4/2020,9/4/2020 17:45,52,44,8,1
--,9/1/2020,9/1/2020,9/4/2020 17:30,53,43,10,1
PA,8/26/2020,8/31/2020,9/4/2020 14:45,51,45,6,1
WI,8/11/2020,8/17/2020,9/4/2020 14:45,52,44,8,1
MI,8/11/2020,8/15/2020,9/4/2020 14:45,52,41,11,1
FL,9/1/2020,9/3/2020,9/4/2020 14:45,46,49,-3,0
TX,8/20/2020,8/25/2020,9/4/2020 14:44,48,45,3,1
--,8/27/2020,9/1/2020,9/4/2020 7:52,52,43,9,1
PA,8/28/2020,9/1/2020,9/3/2020 14:07,52,44,8,1
FL,8/28/2020,9/1/2020,9/3/2020 14:07,48,45,3,1
NC,8/29/2020,9/1/2020,9/3/2020 11:42,48,46,2,1
MN,8/30/2020,9/1/2020,9/3/2020 8:54,48,45,3,1
WI,8/29/2020,9/1/2020,9/2/2020 18:15,50,42,8,1
NC,8/29/2020,9/1/2020,9/2/2020 18:15,50,46,4,1
AZ,8/29/2020,9/1/2020,9/2/2020 18:15,49,40,9,1
--,8/28/2020,9/1/2020,9/2/2020 17:26,51,43,8,1
--,8/28/2020,8/31/2020,9/2/2020 14:34,52,42,10,1
WI,8/21/2020,8/28/2020,9/2/2020 14:25,53,40,13,1
FL,8/21/2020,8/26/2020,9/2/2020 14:25,50,43,7,1
--,8/30/2020,9/1/2020,9/2/2020 12:16,49,41,8,1
PA,8/28/2020,8/31/2020,9/2/2020 11:08,49,46,3,1
--,8/31/2020,9/1/2020,9/2/2020 8:36,47,40,7,1
--,8/28/2020,8/31/2020,9/2/2020 8:36,50,43,7,1
--,8/26/2020,8/30/2020,9/2/2020 8:36,49,41,8,1
--,8/21/2020,8/25/2020,9/2/2020 8:36,56,41,15,1
--,8/30/2020,9/1/2020,9/2/2020 8:00,51,40,11,1
--,8/31/2020,9/1/2020,9/1/2020 19:50,49,41,8,1
NC,8/29/2020,8/30/2020,9/1/2020 16:21,47,49,-2,0
MI,8/28/2020,8/29/2020,9/1/2020 16:20,48,44,4,1
MT,8/22/2020,8/27/2020,9/1/2020 13:21,44,48,-4,0
NV,8/20/2020,8/30/2020,9/1/2020 11:34,44,39,5,1
GA,8/29/2020,8/31/2020,9/1/2020 9:11,41,48,-7,0
FL,8/21/2020,8/30/2020,9/1/2020 8:37,49,47,2,1
PA,8/21/2020,8/30/2020,9/1/2020 8:37,49,45,4,1
NC,8/21/2020,8/30/2020,9/1/2020 8:37,49,47,2,1
OH,8/21/2020,8/30/2020,9/1/2020 8:37,45,50,-5,0
MN,8/21/2020,8/30/2020,9/1/2020 8:37,50,43,7,1
TX,8/21/2020,8/30/2020,9/1/2020 8:37,47,48,-1,0
CO,8/21/2020,8/30/2020,9/1/2020 8:37,51,41,10,1
WI,8/21/2020,8/30/2020,9/1/2020 8:37,52,43,9,1
MI,8/21/2020,8/30/2020,9/1/2020 8:37,52,42,10,1
GA,8/21/2020,8/30/2020,9/1/2020 8:37,49,46,3,1
AZ,8/21/2020,8/30/2020,9/1/2020 8:37,52,42,10,1
FL,8/7/2020,8/16/2020,9/1/2020 8:37,50,45,5,1
PA,8/7/2020,8/16/2020,9/1/2020 8:37,50,44,6,1
NC,8/7/2020,8/16/2020,9/1/2020 8:37,49,46,3,1
OH,8/7/2020,8/16/2020,9/1/2020 8:37,45,49,-4,0
MN,8/7/2020,8/16/2020,9/1/2020 8:37,50,42,8,1
TX,8/7/2020,8/16/2020,9/1/2020 8:37,46,47,-1,0
CO,8/7/2020,8/16/2020,9/1/2020 8:37,51,41,10,1
MI,8/7/2020,8/16/2020,9/1/2020 8:37,50,44,6,1
GA,8/7/2020,8/16/2020,9/1/2020 8:37,46,47,-1,0
AZ,8/7/2020,8/16/2020,9/1/2020 8:37,45,47,-2,0
--,8/28/2020,8/30/2020,9/1/2020 8:37,51,43,8,1
--,8/27/2020,8/29/2020,8/31/2020 14:16,49,43,6,1
PA,8/13/2020,8/19/2020,8/31/2020 12:15,50,42,8,1
GA,8/24/2020,8/25/2020,8/31/2020 12:12,47,46,1,1
MO,8/26/2020,8/28/2020,8/31/2020 10:13,41,52,-11,0
PA,8/20/2020,8/24/2020,8/31/2020 10:13,52,43,9,1
--,8/24/2020,8/30/2020,8/31/2020 8:55,53,41,12,1
--,8/27/2020,8/28/2020,8/29/2020 13:55,47,41,6,1
--,8/29/2020,8/29/2020,8/29/2020 12:15,50,44,6,1
--,8/25/2020,8/26/2020,8/28/2020 12:31,49,39,10,1
MI,8/14/2020,8/23/2020,8/28/2020 12:30,45,47,-2,0
--,8/21/2020,8/24/2020,8/28/2020 8:44,54,41,13,1
PA,8/17/2020,8/23/2020,8/27/2020 10:58,49,42,7,1
VA,8/9/2020,8/22/2020,8/26/2020 11:50,53,39,14,1
--,8/23/2020,8/25/2020,8/26/2020 8:50,50,41,9,1
--,8/19/2020,8/25/2020,8/26/2020 8:49,47,40,7,1
WI,8/21/2020,8/23/2020,8/26/2020 8:46,49,44,5,1
PA,8/21/2020,8/23/2020,8/26/2020 8:46,49,46,3,1
NC,8/21/2020,8/23/2020,8/26/2020 8:46,48,47,1,1
MI,8/21/2020,8/23/2020,8/26/2020 8:46,50,44,6,1
FL,8/21/2020,8/23/2020,8/26/2020 8:46,49,46,3,1
AZ,8/21/2020,8/23/2020,8/26/2020 8:46,49,47,2,1
--,8/21/2020,8/23/2020,8/26/2020 8:46,51,43,8,1
WI,8/14/2020,8/23/2020,8/26/2020 8:40,45,46,-1,0
DE,8/21/2020,8/22/2020,8/25/2020 9:08,58,37,21,1
FL,8/21/2020,8/22/2020,8/25/2020 9:08,48,44,4,1
NY,8/21/2020,8/22/2020,8/25/2020 9:08,63,32,31,1
--,8/21/2020,8/23/2020,8/24/2020 17:39,52,42,10,1
NC,8/14/2020,8/23/2020,8/24/2020 17:38,49,46,3,1
TX,8/21/2020,8/22/2020,8/24/2020 15:53,48,47,1,1
LA,8/13/2020,8/17/2020,8/24/2020 15:52,38,54,-16,0
--,8/21/2020,8/23/2020,8/24/2020 15:51,50,39,11,1
OH,7/28/2020,8/3/2020,8/24/2020 10:17,47,46,1,1
--,8/17/2020,8/23/2020,8/24/2020 8:28,52,40,12,1
--,8/20/2020,8/22/2020,8/23/2020 10:08,52,42,10,1
--,8/19/2020,8/20/2020,8/21/2020 19:08,49,39,10,1
WI,8/16/2020,8/19/2020,8/21/2020 19:08,49,39,10,1
MI,8/16/2020,8/18/2020,8/21/2020 19:08,50,38,12,1
AZ,8/16/2020,8/18/2020,8/21/2020 19:08,47,38,9,1
PA,8/16/2020,8/17/2020,8/21/2020 19:08,48,41,7,1
NC,8/16/2020,8/17/2020,8/21/2020 19:08,44,46,-2,0
FL,8/16/2020,8/16/2020,8/21/2020 19:08,49,41,8,1
WI,8/13/2020,8/17/2020,8/21/2020 15:37,51,45,6,1
PA,8/13/2020,8/17/2020,8/21/2020 15:37,51,44,7,1
OH,8/13/2020,8/17/2020,8/21/2020 15:37,47,47,0,1
MI,8/13/2020,8/17/2020,8/21/2020 15:37,49,46,3,1
NH,8/15/2020,8/17/2020,8/20/2020 19:21,51,43,8,1
PA,8/11/2020,8/17/2020,8/20/2020 14:12,49,45,4,1
--,8/14/2020,8/18/2020,8/20/2020 12:12,51,38,13,1
TX,8/11/2020,8/13/2020,8/20/2020 12:11,47,45,2,1
--,8/13/2020,8/14/2020,8/20/2020 11:59,50,41,9,1
NJ,8/5/2020,8/13/2020,8/20/2020 9:59,52,33,19,1
MN,8/16/2020,8/18/2020,8/20/2020 9:59,47,47,0,1
--,8/14/2020,8/18/2020,8/19/2020 16:58,48,40,8,1
LA,8/6/2020,8/12/2020,8/19/2020 12:57,43,50,-7,0
--,8/16/2020,8/18/2020,8/19/2020 8:43,50,40,10,1
WI,8/7/2020,8/16/2020,8/17/2020 20:08,49,43,6,1
--,8/14/2020,8/16/2020,8/17/2020 20:06,51,43,8,1
--,8/12/2020,8/12/2020,8/17/2020 17:48,48,41,7,1
--,8/14/2020,8/15/2020,8/17/2020 16:24,50,41,9,1
GA,8/14/2020,8/15/2020,8/17/2020 16:23,45,47,-2,0
TX,8/4/2020,8/13/2020,8/17/2020 9:56,41,48,-7,0
--,8/12/2020,8/15/2020,8/16/2020 23:03,54,44,10,1
--,8/12/2020,8/15/2020,8/16/2020 23:03,53,41,12,1
--,8/12/2020,8/15/2020,8/16/2020 20:28,50,46,4,1
NC,8/12/2020,8/13/2020,8/16/2020 20:27,47,47,0,1
--,8/12/2020,8/14/2020,8/16/2020 10:44,52,42,10,1
--,8/9/2020,8/12/2020,8/16/2020 10:44,50,41,9,1
CT,5/19/2020,5/24/2020,8/16/2020 10:43,52,32,20,1
CA,8/9/2020,8/9/2020,8/14/2020 16:14,61,25,36,1
--,8/11/2020,8/11/2020,8/14/2020 9:14,52,40,12,1
--,8/3/2020,8/11/2020,8/14/2020 8:53,53,42,11,1
--,8/6/2020,8/10/2020,8/14/2020 8:52,52,42,10,1
MA,7/31/2020,8/7/2020,8/14/2020 8:51,61,28,33,1
--,8/9/2020,8/12/2020,8/13/2020 19:22,49,42,7,1
--,8/4/2020,8/7/2020,8/13/2020 19:22,47,39,8,1
CA,8/12/2020,8/12/2020,8/13/2020 14:40,56,28,28,1
NC,8/6/2020,8/10/2020,8/13/2020 14:39,45,44,1,1
MS,7/30/2020,8/9/2020,8/13/2020 14:38,43,53,-10,0
--,7/27/2020,8/2/2020,8/13/2020 14:37,53,45,8,1
--,8/10/2020,8/11/2020,8/12/2020 16:16,47,38,9,1
KS,8/5/2020,8/9/2020,8/12/2020 15:30,41,48,-7,0
--,7/21/2020,7/27/2020,8/12/2020 15:29,51,45,6,1
MA,8/6/2020,8/9/2020,8/12/2020 10:53,63,27,36,1
WI,8/7/2020,8/9/2020,8/12/2020 10:51,47,43,4,1
PA,8/7/2020,8/9/2020,8/12/2020 10:51,48,44,4,1
NC,8/7/2020,8/9/2020,8/12/2020 10:51,47,48,-1,0
MI,8/7/2020,8/9/2020,8/12/2020 10:51,48,43,5,1
FL,8/7/2020,8/9/2020,8/12/2020 10:51,50,44,6,1
AZ,8/7/2020,8/9/2020,8/12/2020 10:51,45,44,1,1
--,8/7/2020,8/9/2020,8/12/2020 10:51,50,44,6,1
--,8/9/2020,8/11/2020,8/12/2020 10:44,49,39,10,1
--,8/6/2020,8/10/2020,8/11/2020 13:59,51,41,10,1
ME,7/28/2020,8/9/2020,8/11/2020 13:57,44,36,8,1
WI,8/4/2020,8/9/2020,8/11/2020 13:57,49,44,5,1
GA,8/6/2020,8/8/2020,8/11/2020 8:00,46,44,2,1
AZ,8/5/2020,8/8/2020,8/10/2020 16:43,45,48,-3,0
--,8/6/2020,8/8/2020,8/10/2020 15:27,45,37,8,1
ME,7/27/2020,8/2/2020,8/10/2020 15:27,50,39,11,1
--,8/7/2020,8/9/2020,8/10/2020 15:23,51,43,8,1
--,8/1/2020,8/6/2020,8/10/2020 12:30,50,42,8,1
AZ,8/3/2020,8/4/2020,8/10/2020 10:25,49,45,4,1
WI,7/27/2020,8/6/2020,8/10/2020 7:10,49,43,6,1
PA,7/27/2020,8/6/2020,8/10/2020 7:10,50,41,9,1
MI,7/27/2020,8/6/2020,8/10/2020 7:10,47,43,4,1
WI,8/4/2020,8/7/2020,8/9/2020 17:53,48,42,6,1
PA,8/4/2020,8/7/2020,8/9/2020 17:53,49,43,6,1
TX,8/1/2020,8/5/2020,8/7/2020 12:00,43,49,-6,0
KS,8/5/2020,8/6/2020,8/7/2020 9:24,43,50,-7,0
--,8/3/2020,8/4/2020,8/7/2020 8:12,48,38,10,1
MI,7/25/2020,7/30/2020,8/7/2020 7:24,51,40,11,1
UT,7/27/2020,8/1/2020,8/7/2020 7:23,31,50,-19,0
IA,7/27/2020,7/30/2020,8/6/2020 18:32,40,41,-1,0
SC,7/30/2020,8/3/2020,8/6/2020 15:00,42,47,-5,0
ME,7/30/2020,8/3/2020,8/6/2020 15:00,52,37,15,1
KY,7/30/2020,8/3/2020,8/6/2020 15:00,41,50,-9,0
NC,7/24/2020,8/2/2020,8/6/2020 13:40,46,44,2,1
ME,7/24/2020,8/2/2020,8/6/2020 13:40,49,42,7,1
IA,7/24/2020,8/2/2020,8/6/2020 13:40,42,44,-2,0
AZ,7/24/2020,8/2/2020,8/6/2020 13:40,45,43,2,1
WI,7/30/2020,7/31/2020,8/6/2020 13:40,53,42,11,1
MN,7/30/2020,7/31/2020,8/6/2020 13:40,54,36,18,1
MI,7/30/2020,7/31/2020,8/6/2020 13:40,51,41,10,1
IA,7/30/2020,7/31/2020,8/6/2020 13:40,49,43,6,1
OK,7/29/2020,7/30/2020,8/6/2020 13:40,36,56,-20,0
IN,7/24/2020,8/2/2020,8/5/2020 17:16,38,55,-17,0
--,8/3/2020,8/4/2020,8/5/2020 15:23,56,44,12,1
IA,7/30/2020,8/3/2020,8/5/2020 11:05,47,48,-1,0
--,8/2/2020,8/4/2020,8/5/2020 11:05,49,40,9,1
HI,7/27/2020,7/30/2020,8/5/2020 11:05,56,29,27,1
WI,7/22/2020,7/27/2020,8/5/2020 11:05,52,38,14,1
PA,7/17/2020,7/22/2020,8/5/2020 11:05,51,45,6,1
MI,7/13/2020,7/16/2020,8/5/2020 11:05,53,41,12,1
TX,7/24/2020,8/2/2020,8/4/2020 18:52,47,46,1,1
SC,7/24/2020,8/2/2020,8/4/2020 18:52,44,49,-5,0
KY,7/24/2020,8/2/2020,8/4/2020 18:52,35,58,-23,0
AL,7/24/2020,8/2/2020,8/4/2020 18:52,36,58,-22,0
CA,7/21/2020,7/27/2020,8/4/2020 18:50,67,28,39,1
MI,7/28/2020,7/29/2020,8/3/2020 20:46,49,43,6,1
--,7/23/2020,7/27/2020,8/3/2020 20:45,48,41,7,1
WI,7/11/2020,7/17/2020,8/3/2020 20:44,51,42,9,1
OH,6/25/2020,7/15/2020,8/3/2020 20:43,46,42,4,1
--,7/31/2020,8/2/2020,8/3/2020 15:23,51,42,9,1
GA,7/28/2020,7/31/2020,8/2/2020 11:02,46,45,1,1
NC,7/28/2020,7/31/2020,8/2/2020 11:02,48,44,4,1
--,7/28/2020,7/30/2020,7/31/2020 10:54,49,40,9,1
--,7/28/2020,7/28/2020,7/31/2020 10:54,52,42,10,1
MN,7/22/2020,7/23/2020,7/31/2020 10:53,52,42,10,1
--,7/25/2020,7/28/2020,7/30/2020 16:04,48,41,7,1
NH,7/16/2020,7/28/2020,7/30/2020 16:04,53,40,13,1
VA,7/11/2020,7/18/2020,7/30/2020 16:04,50,39,11,1
NH,6/18/2020,6/22/2020,7/30/2020 16:04,52,39,13,1
NH,5/14/2020,5/18/2020,7/30/2020 16:04,44,46,-2,0
PA,7/20/2020,7/26/2020,7/30/2020 9:06,50,41,9,1
NC,7/22/2020,7/24/2020,7/30/2020 9:06,47,48,-1,0
WI,7/19/2020,7/24/2020,7/30/2020 9:06,45,35,10,1
MI,7/19/2020,7/24/2020,7/30/2020 9:06,49,37,12,1
FL,7/20/2020,7/23/2020,7/30/2020 9:06,50,46,4,1
AZ,7/19/2020,7/24/2020,7/30/2020 9:06,46,38,8,1
PA,7/19/2020,7/24/2020,7/30/2020 9:06,48,41,7,1
FL,7/19/2020,7/24/2020,7/30/2020 9:06,48,41,7,1
NC,7/19/2020,7/24/2020,7/30/2020 9:06,43,42,1,1
--,7/24/2020,7/28/2020,7/29/2020 17:36,48,40,8,1
WI,7/24/2020,7/26/2020,7/29/2020 14:10,48,43,5,1
PA,7/24/2020,7/26/2020,7/29/2020 14:10,48,46,2,1
NC,7/24/2020,7/26/2020,7/29/2020 14:10,49,46,3,1
MI,7/24/2020,7/26/2020,7/29/2020 14:10,46,42,4,1
FL,7/24/2020,7/26/2020,7/29/2020 14:10,48,45,3,1
AZ,7/24/2020,7/26/2020,7/29/2020 14:10,47,45,2,1
--,7/24/2020,7/26/2020,7/29/2020 14:10,51,42,9,1
--,7/27/2020,7/28/2020,7/29/2020 14:07,47,38,9,1
--,7/27/2020,7/28/2020,7/29/2020 11:12,49,40,9,1
GA,7/23/2020,7/27/2020,7/29/2020 11:11,47,48,-1,0
WA,7/22/2020,7/27/2020,7/28/2020 20:53,62,28,34,1
ME,7/18/2020,7/24/2020,7/28/2020 20:51,50,38,12,1
WI,7/17/2020,7/26/2020,7/28/2020 15:24,50,43,7,1
VA,7/17/2020,7/26/2020,7/28/2020 15:24,52,41,11,1
TX,7/17/2020,7/26/2020,7/28/2020 15:24,47,45,2,1
PA,7/17/2020,7/26/2020,7/28/2020 15:24,50,42,8,1
OH,7/17/2020,7/26/2020,7/28/2020 15:24,45,48,-3,0
NC,7/17/2020,7/26/2020,7/28/2020 15:24,47,47,0,1
MN,7/17/2020,7/26/2020,7/28/2020 15:24,47,44,3,1
MI,7/17/2020,7/26/2020,7/28/2020 15:24,52,42,10,1
GA,7/17/2020,7/26/2020,7/28/2020 15:24,47,46,1,1
FL,7/17/2020,7/26/2020,7/28/2020 15:24,49,46,3,1
CO,7/17/2020,7/26/2020,7/28/2020 15:24,52,39,13,1
AZ,7/17/2020,7/26/2020,7/28/2020 15:24,49,42,7,1
NC,7/23/2020,7/24/2020,7/28/2020 15:21,49,46,3,1
MT,7/23/2020,7/24/2020,7/28/2020 15:21,45,50,-5,0
ME,7/23/2020,7/24/2020,7/28/2020 15:21,53,42,11,1
IA,7/23/2020,7/24/2020,7/28/2020 15:21,47,48,-1,0
GA,7/23/2020,7/24/2020,7/28/2020 15:21,46,45,1,1
CO,7/23/2020,7/24/2020,7/28/2020 15:21,54,41,13,1
AK,7/23/2020,7/24/2020,7/28/2020 15:21,44,50,-6,0
MA,7/17/2020,7/20/2020,7/28/2020 14:53,55,23,32,1
NJ,7/7/2020,7/12/2020,7/28/2020 14:52,51,33,18,1
--,7/23/2020,7/25/2020,7/27/2020 17:04,45,37,8,1
MN,7/23/2020,7/25/2020,7/27/2020 17:03,49,44,5,1
--,7/21/2020,7/23/2020,7/27/2020 13:19,55,45,10,1
OH,7/21/2020,7/24/2020,7/26/2020 19:31,45,46,-1,0
MI,7/21/2020,7/24/2020,7/26/2020 19:31,48,42,6,1
--,7/21/2020,7/24/2020,7/26/2020 19:31,51,41,10,1
MI,7/18/2020,7/24/2020,7/26/2020 19:31,52,40,12,1
FL,7/18/2020,7/24/2020,7/26/2020 19:31,51,46,5,1
AZ,7/18/2020,7/24/2020,7/26/2020 19:31,49,45,4,1
AZ,7/14/2020,7/22/2020,7/26/2020 19:31,50,45,5,1
--,7/14/2020,7/19/2020,7/26/2020 12:59,47,38,9,1
NC,7/14/2020,7/22/2020,7/26/2020 9:42,51,44,7,1
--,7/16/2020,7/20/2020,7/26/2020 9:42,46,34,12,1
PA,7/22/2020,7/24/2020,7/25/2020 12:48,48,45,3,1
MI,7/22/2020,7/22/2020,7/24/2020 20:34,51,42,9,1
WI,7/22/2020,7/22/2020,7/24/2020 20:34,50,42,8,1
--,7/21/2020,7/21/2020,7/24/2020 20:34,50,44,6,1
--,7/17/2020,7/22/2020,7/24/2020 20:33,50,37,13,1
--,4/18/2020,4/21/2020,7/24/2020 20:33,52,43,9,1
--,3/20/2020,3/24/2020,7/24/2020 20:33,51,41,10,1
--,1/20/2020,1/23/2020,7/24/2020 20:33,49,40,9,1
PA,7/17/2020,7/20/2020,7/23/2020 17:58,50,39,11,1
MN,7/17/2020,7/20/2020,7/23/2020 17:58,51,38,13,1
MI,7/17/2020,7/20/2020,7/23/2020 17:58,49,40,9,1
--,5/13/2020,5/15/2020,7/23/2020 17:34,51,43,8,1
--,6/23/2020,7/1/2020,7/23/2020 17:33,50,39,11,1
--,7/15/2020,7/19/2020,7/23/2020 16:43,55,44,11,1
FL,7/16/2020,7/20/2020,7/23/2020 16:41,51,38,13,1
FL,7/13/2020,7/14/2020,7/23/2020 9:07,50,44,6,1
TX,7/16/2020,7/20/2020,7/22/2020 14:46,45,44,1,1
GA,7/9/2020,7/15/2020,7/22/2020 14:45,47,43,4,1
AZ,7/17/2020,7/18/2020,7/22/2020 11:12,49,45,4,1
--,7/19/2020,7/21/2020,7/22/2020 10:03,48,41,7,1
--,7/15/2020,7/21/2020,7/22/2020 10:03,46,38,8,1
--,7/13/2020,7/19/2020,7/22/2020 10:03,47,40,7,1
GA,7/15/2020,7/18/2020,7/20/2020 16:59,43,50,-7,0
NC,7/13/2020,7/15/2020,7/20/2020 16:57,48,49,-1,0
--,7/15/2020,7/18/2020,7/20/2020 11:50,50,39,11,1
SC,7/17/2020,7/17/2020,7/19/2020 14:30,46,50,-4,0
MI,7/9/2020,7/10/2020,7/19/2020 14:30,51,44,7,1
--,7/12/2020,7/15/2020,7/19/2020 9:25,49,41,8,1
--,7/12/2020,7/15/2020,7/19/2020 0:55,54,44,10,1
--,7/12/2020,7/15/2020,7/19/2020 0:55,55,40,15,1
AK,6/23/2020,7/7/2020,7/17/2020 20:13,48,49,-1,0
--,7/2/2020,7/8/2020,7/17/2020 12:49,49,41,8,1
--,4/9/2020,4/15/2020,7/17/2020 12:48,48,43,5,1
KY,7/7/2020,7/12/2020,7/16/2020 16:57,41,53,-12,0
AZ,7/6/2020,7/7/2020,7/16/2020 8:56,49,44,5,1
--,7/9/2020,7/12/2020,7/15/2020 17:08,51,40,11,1
--,7/13/2020,7/14/2020,7/15/2020 17:06,47,37,10,1
--,7/9/2020,7/13/2020,7/15/2020 16:15,52,37,15,1
--,7/11/2020,7/14/2020,7/15/2020 12:21,47,39,8,1
PA,7/9/2020,7/13/2020,7/15/2020 11:15,52,43,9,1
--,7/12/2020,7/14/2020,7/15/2020 10:02,49,40,9,1
--,7/6/2020,7/13/2020,7/15/2020 8:49,47,39,8,1
WI,7/10/2020,7/12/2020,7/15/2020 8:49,48,42,6,1
PA,7/10/2020,7/12/2020,7/15/2020 8:49,50,42,8,1
NC,7/10/2020,7/12/2020,7/15/2020 8:49,47,46,1,1
MI,7/10/2020,7/12/2020,7/15/2020 8:49,48,42,6,1
FL,7/10/2020,7/12/2020,7/15/2020 8:49,50,43,7,1
AZ,7/10/2020,7/12/2020,7/15/2020 8:49,51,45,6,1
--,7/10/2020,7/12/2020,7/15/2020 8:49,51,41,10,1
FL,7/13/2020,7/13/2020,7/14/2020 10:45,53,43,10,1
MT,7/11/2020,7/13/2020,7/14/2020 8:53,45,49,-4,0
--,7/9/2020,7/9/2020,7/13/2020 14:23,48,40,8,1
--,7/9/2020,7/11/2020,7/13/2020 14:23,46,39,7,1
MT,7/9/2020,7/10/2020,7/13/2020 11:04,42,51,-9,0
MO,6/23/2020,7/1/2020,7/13/2020 11:04,43,50,-7,0
TX,7/7/2020,7/10/2020,7/12/2020 11:56,45,46,-1,0
FL,7/7/2020,7/10/2020,7/12/2020 11:56,48,42,6,1
AZ,7/7/2020,7/10/2020,7/12/2020 11:56,46,46,0,1
TX,6/29/2020,7/7/2020,7/12/2020 11:55,48,43,5,1
--,6/29/2020,7/5/2020,7/10/2020 18:40,48,39,9,1
NC,4/13/2020,4/16/2020,7/10/2020 18:40,48,46,2,1
IA,4/13/2020,4/16/2020,7/10/2020 18:40,45,48,-3,0
AZ,4/13/2020,4/16/2020,7/10/2020 18:40,47,46,1,1
--,7/7/2020,7/7/2020,7/10/2020 11:10,52,42,10,1
--,7/7/2020,7/7/2020,7/10/2020 11:10,52,42,10,1
NC,7/7/2020,7/8/2020,7/9/2020 14:42,50,46,4,1
AK,7/7/2020,7/8/2020,7/9/2020 10:30,45,48,-3,0
--,7/6/2020,7/7/2020,7/8/2020 11:14,43,37,6,1
--,7/1/2020,7/2/2020,7/8/2020 11:13,49,40,9,1
--,6/19/2020,6/25/2020,7/8/2020 11:09,52,40,12,1
--,6/12/2020,6/28/2020,7/8/2020 9:35,47,37,10,1
--,5/16/2020,5/31/2020,7/8/2020 9:35,46,37,9,1
--,5/2/2020,5/15/2020,7/8/2020 9:35,43,39,4,1
--,4/16/2020,4/30/2020,7/8/2020 9:35,44,40,4,1
--,7/5/2020,7/7/2020,7/8/2020 9:22,49,40,9,1
--,6/25/2020,6/26/2020,7/7/2020 13:29,53,42,11,1
PA,6/29/2020,7/2/2020,7/6/2020 13:52,48,43,5,1
ME,7/2/2020,7/3/2020,7/6/2020 10:25,53,42,11,1
FL,6/29/2020,7/2/2020,7/3/2020 22:52,46,46,0,1
--,6/19/2020,7/1/2020,7/2/2020 15:48,45,40,5,1
--,6/26/2020,6/30/2020,7/2/2020 11:06,52,39,13,1
TX,6/19/2020,6/29/2020,7/2/2020 10:52,44,48,-4,0
TX,6/24/2020,6/25/2020,7/2/2020 8:58,48,46,2,1
MT,6/17/2020,6/26/2020,7/2/2020 8:57,38,52,-14,0
--,6/22/2020,6/28/2020,7/1/2020 20:21,55,41,14,1
--,6/29/2020,6/30/2020,7/1/2020 17:42,46,38,8,1
MI,6/26/2020,6/27/2020,7/1/2020 17:42,50,44,6,1
--,6/17/2020,6/18/2020,7/1/2020 17:41,56,44,12,1
CO,6/29/2020,6/30/2020,7/1/2020 14:17,56,39,17,1
--,6/27/2020,6/30/2020,7/1/2020 13:53,48,40,8,1
AZ,6/27/2020,6/29/2020,7/1/2020 12:13,47,45,2,1
--,6/28/2020,6/30/2020,7/1/2020 9:55,49,40,9,1
WI,6/26/2020,6/28/2020,7/1/2020 8:49,51,43,8,1
PA,6/26/2020,6/28/2020,7/1/2020 8:49,50,44,6,1
NC,6/26/2020,6/28/2020,7/1/2020 8:49,51,44,7,1
MI,6/26/2020,6/28/2020,7/1/2020 8:49,48,43,5,1
FL,6/26/2020,6/28/2020,7/1/2020 8:49,50,45,5,1
AZ,6/26/2020,6/28/2020,7/1/2020 8:49,51,44,7,1
--,6/26/2020,6/28/2020,7/1/2020 8:49,47,40,7,1
--,6/22/2020,6/28/2020,7/1/2020 8:48,47,40,7,1
NC,6/22/2020,6/25/2020,6/30/2020 17:34,45,44,1,1
--,6/25/2020,6/29/2020,6/30/2020 14:16,46,37,9,1
--,6/25/2020,6/29/2020,6/30/2020 14:16,53,41,12,1
--,6/16/2020,6/22/2020,6/30/2020 11:09,54,44,10,1
NY,6/23/2020,6/25/2020,6/30/2020 9:41,57,32,25,1
MO,6/16/2020,6/22/2020,6/30/2020 9:40,48,46,2,1
--,6/25/2020,6/27/2020,6/29/2020 21:05,45,41,4,1
--,6/25/2020,6/27/2020,6/29/2020 21:05,41,31,10,1
PA,6/15/2020,6/23/2020,6/29/2020 14:07,46,41,5,1
--,6/25/2020,6/27/2020,6/29/2020 11:00,47,39,8,1
GA,6/25/2020,6/26/2020,6/29/2020 9:22,49,45,4,1
WI,6/23/2020,6/25/2020,6/28/2020 21:03,45,46,-1,0
--,6/6/2020,6/11/2020,6/26/2020 13:51,48,41,7,1
--,6/24/2020,6/25/2020,6/26/2020 12:53,47,39,8,1
--,6/22/2020,6/24/2020,6/26/2020 12:13,52,44,8,1
--,6/8/2020,6/14/2020,6/26/2020 11:25,51,38,13,1
TX,6/20/2020,6/23/2020,6/25/2020 18:19,45,44,1,1
NC,6/20/2020,6/23/2020,6/25/2020 18:19,47,45,2,1
GA,6/20/2020,6/23/2020,6/25/2020 18:19,47,45,2,1
FL,6/20/2020,6/23/2020,6/25/2020 18:19,49,40,9,1
WI,6/14/2020,6/19/2020,6/25/2020 12:22,45,36,9,1
NC,6/14/2020,6/17/2020,6/25/2020 12:22,46,40,6,1
AZ,6/14/2020,6/17/2020,6/25/2020 12:22,43,39,4,1
MI,6/14/2020,6/16/2020,6/25/2020 12:22,47,36,11,1
PA,6/14/2020,6/16/2020,6/25/2020 12:22,49,39,10,1
FL,6/14/2020,6/15/2020,6/25/2020 12:22,45,41,4,1
MI,6/17/2020,6/20/2020,6/25/2020 10:08,56,38,18,1
WI,6/12/2020,6/16/2020,6/25/2020 10:08,55,39,16,1
PA,6/8/2020,6/11/2020,6/25/2020 10:08,54,42,12,1
--,6/19/2020,6/22/2020,6/25/2020 9:13,47,38,9,1
NC,6/8/2020,6/18/2020,6/25/2020 9:11,49,40,9,1
FL,6/8/2020,6/18/2020,6/25/2020 9:11,47,41,6,1
MI,6/8/2020,6/17/2020,6/25/2020 9:11,47,36,11,1
PA,6/8/2020,6/16/2020,6/25/2020 9:11,50,40,10,1
AZ,6/8/2020,6/16/2020,6/25/2020 9:11,48,41,7,1
WI,6/8/2020,6/15/2020,6/25/2020 9:11,49,38,11,1
--,6/22/2020,6/23/2020,6/24/2020 17:27,47,37,10,1
NC,6/22/2020,6/23/2020,6/24/2020 14:57,48,46,2,1
OH,6/18/2020,6/22/2020,6/24/2020 14:56,46,45,1,1
WI,6/14/2020,6/18/2020,6/24/2020 13:21,50,44,6,1
--,6/21/2020,6/23/2020,6/24/2020 10:06,49,41,8,1
--,6/15/2020,6/21/2020,6/24/2020 9:20,47,39,8,1
--,6/23/2020,6/23/2020,6/24/2020 9:09,50,44,6,1
--,6/23/2020,6/23/2020,6/24/2020 9:09,52,43,9,1
--,6/17/2020,6/22/2020,6/24/2020 8:17,50,36,14,1
--,6/19/2020,6/20/2020,6/23/2020 16:33,52,43,9,1
TX,6/18/2020,6/19/2020,6/23/2020 16:33,46,48,-2,0
--,4/3/2020,4/7/2020,6/23/2020 16:32,47,41,6,1
--,4/3/2020,4/7/2020,6/23/2020 16:32,42,37,5,1
--,6/17/2020,6/18/2020,6/22/2020 19:30,56,44,12,1
--,6/12/2020,6/16/2020,6/22/2020 16:49,50,42,8,1
--,5/18/2020,5/20/2020,6/22/2020 16:48,51,42,9,1
AL,5/14/2020,5/18/2020,6/22/2020 11:22,39,52,-13,0
MI,6/16/2020,6/18/2020,6/22/2020 9:19,46,45,1,1
MN,6/19/2020,6/19/2020,6/20/2020 15:12,58,42,16,1
--,6/12/2020,6/16/2020,6/20/2020 11:40,53,43,10,1
--,5/28/2020,6/10/2020,6/18/2020 22:19,50,39,11,1
NH,6/13/2020,6/16/2020,6/18/2020 18:51,49,42,7,1
--,6/13/2020,6/16/2020,6/18/2020 18:50,50,38,12,1
--,6/9/2020,6/16/2020,6/18/2020 16:03,50,44,6,1
--,6/9/2020,6/16/2020,6/18/2020 16:03,42,37,5,1
--,6/11/2020,6/15/2020,6/18/2020 16:02,49,41,8,1
KY,6/13/2020,6/15/2020,6/18/2020 13:10,37,57,-20,0
--,5/18/2020,5/24/2020,6/17/2020 17:53,46,39,7,1
--,6/10/2020,6/16/2020,6/17/2020 15:39,48,35,13,1
AZ,6/12/2020,6/14/2020,6/17/2020 15:37,45,44,1,1
NC,6/12/2020,6/14/2020,6/17/2020 15:37,47,45,2,1
MI,6/12/2020,6/14/2020,6/17/2020 15:37,47,45,2,1
WI,6/12/2020,6/14/2020,6/17/2020 15:37,48,44,4,1
PA,6/12/2020,6/14/2020,6/17/2020 15:37,49,46,3,1
FL,6/12/2020,6/14/2020,6/17/2020 15:37,50,43,7,1
--,6/12/2020,6/14/2020,6/17/2020 15:37,51,41,10,1
--,6/14/2020,6/16/2020,6/17/2020 9:37,50,41,9,1
MS,6/2/2020,6/4/2020,6/16/2020 20:18,41,50,-9,0
AZ,6/13/2020,6/15/2020,6/16/2020 12:07,49,45,4,1
GA,6/12/2020,6/13/2020,6/16/2020 12:06,48,46,2,1
NM,6/12/2020,6/13/2020,6/16/2020 12:06,53,39,14,1
MI,6/9/2020,6/12/2020,6/16/2020 12:05,51,38,13,1
MI,6/9/2020,6/12/2020,6/16/2020 12:05,50,37,13,1
FL,6/9/2020,6/11/2020,6/16/2020 12:03,51,40,11,1
FL,6/9/2020,6/11/2020,6/16/2020 12:03,50,40,10,1
--,5/21/2020,6/5/2020,6/16/2020 12:03,40,32,8,1
MI,5/31/2020,6/4/2020,6/16/2020 12:02,55,39,16,1
IA,6/7/2020,6/10/2020,6/15/2020 19:21,43,44,-1,0
--,6/6/2020,6/14/2020,6/15/2020 17:09,48,39,9,1
--,6/6/2020,6/13/2020,6/15/2020 17:09,52,43,9,1
--,6/6/2020,6/13/2020,6/15/2020 17:09,43,34,9,1
--,6/11/2020,6/13/2020,6/15/2020 16:55,48,36,12,1
--,6/11/2020,6/13/2020,6/15/2020 10:35,51,41,10,1
--,6/11/2020,6/13/2020,6/15/2020 10:35,49,35,14,1
MO,6/10/2020,6/11/2020,6/13/2020 10:25,43,51,-8,0
--,6/8/2020,6/9/2020,6/11/2020 17:36,50,37,13,1
--,6/2/2020,6/9/2020,6/11/2020 17:35,53,42,11,1
--,6/2/2020,6/9/2020,6/11/2020 17:35,43,32,11,1
FL,5/18/2020,5/30/2020,6/11/2020 15:05,47,44,3,1
GA,5/21/2020,5/27/2020,6/11/2020 15:04,40,44,-4,0
--,6/9/2020,6/10/2020,6/11/2020 11:01,49,40,9,1
--,6/8/2020,6/9/2020,6/9/2020 22:50,46,38,8,1
--,6/7/2020,6/7/2020,6/9/2020 22:48,46,39,7,1
MI,5/31/2020,6/7/2020,6/9/2020 22:46,50,35,15,1
--,6/2/2020,6/2/2020,6/9/2020 22:45,54,40,14,1
--,6/2/2020,6/2/2020,6/9/2020 22:45,52,42,10,1
--,5/26/2020,5/26/2020,6/9/2020 22:44,50,46,4,1
--,5/26/2020,5/26/2020,6/9/2020 22:44,51,43,8,1
--,6/7/2020,6/9/2020,6/9/2020 13:17,49,41,8,1
IA,6/6/2020,6/8/2020,6/9/2020 11:23,46,46,0,1
KY,5/21/2020,5/24/2020,6/9/2020 11:22,36,53,-17,0
TN,5/2/2020,5/22/2020,6/9/2020 11:21,42,51,-9,0
--,6/1/2020,6/7/2020,6/9/2020 9:25,47,39,8,1
--,5/30/2020,6/6/2020,6/9/2020 9:24,53,42,11,1
OK,6/3/2020,6/4/2020,6/9/2020 9:17,36,55,-19,0
--,5/25/2020,5/31/2020,6/9/2020 9:15,46,41,5,1
--,6/4/2020,6/6/2020,6/8/2020 15:40,47,37,10,1
--,6/3/2020,6/6/2020,6/8/2020 15:39,53,41,12,1
MI,5/30/2020,6/3/2020,6/7/2020 9:28,53,41,12,1
--,5/28/2020,6/2/2020,6/7/2020 9:26,49,42,7,1
--,6/2/2020,6/5/2020,6/7/2020 6:27,55,41,14,1
TX,6/3/2020,6/4/2020,6/5/2020 14:48,48,48,0,1
IA,6/3/2020,6/4/2020,6/5/2020 14:47,47,48,-1,0
--,6/2/2020,6/4/2020,6/5/2020 14:46,53,43,10,1
--,6/2/2020,6/3/2020,6/5/2020 14:44,50,43,7,1
NC,6/2/2020,6/3/2020,6/4/2020 22:56,49,45,4,1
--,6/1/2020,6/3/2020,6/4/2020 22:55,47,44,3,1
--,5/31/2020,6/3/2020,6/4/2020 22:54,45,42,3,1
--,5/26/2020,6/2/2020,6/4/2020 22:53,51,44,7,1
CA,5/17/2020,5/26/2020,6/4/2020 22:51,57,33,24,1
WI,5/30/2020,6/2/2020,6/3/2020 20:02,49,40,9,1
OH,5/30/2020,6/2/2020,6/3/2020 20:02,45,43,2,1
AZ,5/30/2020,6/2/2020,6/3/2020 20:02,46,42,4,1
--,5/31/2020,6/2/2020,6/3/2020 17:23,47,40,7,1
TX,5/29/2020,6/1/2020,6/3/2020 17:21,43,44,-1,0
--,5/28/2020,6/1/2020,6/3/2020 17:21,52,41,11,1
WI,5/29/2020,5/31/2020,6/3/2020 17:19,45,45,0,1
PA,5/29/2020,5/31/2020,6/3/2020 17:19,46,50,-4,0
NC,5/29/2020,5/31/2020,6/3/2020 17:19,46,45,1,1
MI,5/29/2020,5/31/2020,6/3/2020 17:19,48,46,2,1
FL,5/29/2020,5/31/2020,6/3/2020 17:19,48,45,3,1
AZ,5/29/2020,5/31/2020,6/3/2020 17:19,44,45,-1,0
--,5/29/2020,5/31/2020,6/3/2020 17:19,48,41,7,1
NC,5/26/2020,5/28/2020,6/3/2020 17:18,44,47,-3,0
--,6/1/2020,6/2/2020,6/2/2020 19:28,47,37,10,1
KS,5/30/2020,6/1/2020,6/2/2020 19:28,40,52,-12,0
--,5/29/2020,6/1/2020,6/2/2020 19:26,47,43,4,1
--,5/28/2020,5/30/2020,6/2/2020 19:25,46,39,7,1
MI,5/29/2020,5/30/2020,6/1/2020 19:33,50,44,6,1
--,5/23/2020,5/30/2020,6/1/2020 19:32,50,45,5,1
--,5/31/2020,6/1/2020,6/1/2020 19:28,51,39,12,1
--,5/2/2020,5/3/2020,6/1/2020 19:28,45,41,4,1
--,5/21/2020,5/27/2020,6/1/2020 13:13,43,40,3,1
--,5/29/2020,5/30/2020,5/31/2020 18:36,48,40,8,1
--,5/25/2020,5/28/2020,5/31/2020 0:31,51,46,5,1
--,5/25/2020,5/28/2020,5/31/2020 0:31,53,43,10,1
FL,5/26/2020,5/27/2020,5/30/2020 18:18,48,47,1,1
MO,5/26/2020,5/27/2020,5/30/2020 18:11,44,48,-4,0
--,5/19/2020,5/26/2020,5/30/2020 18:10,52,44,8,1
--,5/20/2020,5/27/2020,5/27/2020 19:51,45,39,6,1
--,5/23/2020,5/26/2020,5/27/2020 19:51,45,42,3,1
SC,5/23/2020,5/26/2020,5/27/2020 19:50,42,52,-10,0
--,5/18/2020,5/24/2020,5/27/2020 19:49,46,41,5,1
NY,5/17/2020,5/21/2020,5/27/2020 19:48,57,32,25,1
--,5/16/2020,5/23/2020,5/27/2020 19:47,54,43,11,1
AZ,5/18/2020,5/22/2020,5/27/2020 19:46,47,45,2,1
NC,5/9/2020,5/13/2020,5/27/2020 19:41,47,47,0,1
MD,5/19/2020,5/23/2020,5/26/2020 12:20,59,35,24,1
UT,5/9/2020,5/15/2020,5/26/2020 12:19,41,44,-3,0
MN,5/18/2020,5/20/2020,5/24/2020 14:37,49,44,5,1
--,5/20/2020,5/21/2020,5/22/2020 21:51,46,42,4,1
WA,5/19/2020,5/20/2020,5/22/2020 21:44,59,37,22,1
--,5/12/2020,4/19/2020,5/22/2020 21:40,52,42,10,1
--,5/13/2020,5/18/2020,5/22/2020 9:35,43,41,2,1
--,5/17/2020,5/20/2020,5/21/2020 20:34,48,40,8,1
--,5/19/2020,5/19/2020,5/21/2020 20:34,51,42,9,1
MI,5/18/2020,5/19/2020,5/21/2020 20:27,51,45,6,1
WA,5/16/2020,5/19/2020,5/21/2020 20:26,57,31,26,1
MI,5/16/2020,5/19/2020,5/21/2020 20:25,47,44,3,1
WI,5/10/2020,5/14/2020,5/21/2020 20:24,48,38,10,1
MI,5/10/2020,5/14/2020,5/21/2020 20:24,47,39,8,1
PA,5/10/2020,5/14/2020,5/21/2020 20:24,48,39,9,1
FL,5/10/2020,5/14/2020,5/21/2020 20:24,45,43,2,1
NC,5/10/2020,5/14/2020,5/21/2020 20:24,45,43,2,1
AZ,5/10/2020,5/14/2020,5/21/2020 20:24,45,41,4,1
PA,5/9/2020,5/13/2020,5/21/2020 20:21,46,50,-4,0
--,5/12/2020,5/12/2020,5/21/2020 20:21,48,41,7,1
WI,5/6/2020,5/8/2020,5/21/2020 20:20,51,42,9,1
MI,5/1/2020,5/5/2020,5/21/2020 20:14,50,42,8,1
CA,5/18/2020,5/19/2020,5/21/2020 20:07,58,30,28,1
--,5/18/2020,5/19/2020,5/21/2020 20:06,47,38,9,1
--,5/14/2020,5/18/2020,5/21/2020 20:05,50,39,11,1
KY,5/14/2020,5/15/2020,5/21/2020 20:03,39,55,-16,0
--,5/17/2020,5/19/2020,5/20/2020 12:20,47,42,5,1
--,5/15/2020,5/17/2020,5/20/2020 12:18,48,45,3,1
--,5/11/2020,5/17/2020,5/20/2020 12:16,46,41,5,1
GA,5/16/2020,5/18/2020,5/20/2020 12:12,48,47,1,1
FL,5/14/2020,5/17/2020,5/20/2020 12:09,45,44,1,1
VA,5/3/2020,5/16/2020,5/20/2020 12:05,51,39,12,1
AZ,5/9/2020,5/11/2020,5/20/2020 12:03,50,43,7,1
TN,4/22/2020,5/1/2020,5/20/2020 11:59,36,53,-17,0
--,5/14/2020,5/16/2020,5/20/2020 11:57,43,39,4,1
--,5/9/2020,5/16/2020,5/20/2020 11:57,52,41,11,1
--,5/13/2020,5/14/2020,5/20/2020 11:54,53,47,6,1
--,5/13/2020,5/14/2020,5/20/2020 11:54,53,47,6,1
CO,5/7/2020,5/11/2020,5/20/2020 11:50,53,40,13,1
GA,5/11/2020,5/13/2020,5/16/2020 12:36,46,48,-2,0
NC,5/7/2020,5/9/2020,5/16/2020 12:35,43,46,-3,0
--,5/5/2020,5/5/2020,5/16/2020 12:31,50,44,6,1
--,4/28/2020,4/28/2020,5/16/2020 12:31,52,43,9,1
--,4/21/2020,4/21/2020,5/16/2020 12:31,49,44,5,1
--,4/14/2020,4/14/2020,5/16/2020 12:31,49,45,4,1
FL,5/8/2020,5/12/2020,5/15/2020 11:13,53,47,6,1
--,5/5/2020,5/12/2020,5/15/2020 11:10,52,43,9,1
NJ,4/22/2020,5/2/2020,5/15/2020 11:08,56,33,23,1
--,5/10/2020,5/12/2020,5/13/2020 14:08,47,43,4,1
--,5/7/2020,5/10/2020,5/13/2020 14:06,51,46,5,1
GA,5/4/2020,5/7/2020,5/13/2020 14:04,47,46,1,1
--,5/11/2020,5/12/2020,5/13/2020 14:03,46,38,8,1
WI,5/3/2020,5/7/2020,5/12/2020 17:25,49,45,4,1
--,5/4/2020,5/10/2020,5/11/2020 18:30,52,45,7,1
--,5/8/2020,5/9/2020,5/11/2020 18:25,52,44,8,1
--,5/7/2020,5/9/2020,5/11/2020 18:24,44,38,6,1
--,5/2/2020,5/9/2020,5/11/2020 18:17,50,45,5,1
--,5/4/2020,5/5/2020,5/7/2020 17:54,45,42,3,1
--,4/28/2020,5/5/2020,5/7/2020 17:54,51,45,6,1
MA,4/27/2020,5/1/2020,5/7/2020 17:53,58,30,28,1
CT,4/30/2020,5/4/2020,5/7/2020 17:50,56,33,23,1
NJ,4/30/2020,5/4/2020,5/7/2020 17:50,54,35,19,1
NY,4/30/2020,5/4/2020,5/7/2020 17:50,55,32,23,1
NV,4/27/2020,4/30/2020,5/7/2020 17:48,49,45,4,1
--,5/3/2020,5/5/2020,5/6/2020 11:39,46,42,4,1
CO,5/1/2020,5/3/2020,5/6/2020 11:37,55,35,20,1
--,4/30/2020,5/4/2020,5/6/2020 11:36,47,40,7,1
--,5/1/2020,5/3/2020,5/6/2020 11:33,47,44,3,1
--,5/2/2020,5/5/2020,5/6/2020 11:32,47,44,3,1
--,5/4/2020,5/5/2020,5/6/2020 11:32,43,41,2,1
NC,5/2/2020,5/4/2020,5/6/2020 11:32,49,48,1,1
--,4/30/2020,5/2/2020,5/6/2020 11:31,46,39,7,1
MT,4/10/2020,4/27/2020,5/6/2020 11:30,40,45,-5,0
CO,4/10/2020,4/27/2020,5/6/2020 11:28,53,35,18,1
--,4/27/2020,5/3/2020,5/6/2020 11:27,46,42,4,1
--,4/25/2020,5/2/2020,5/6/2020 11:26,50,45,5,1
IA,4/30/2020,5/1/2020,5/4/2020 15:03,46,48,-2,0
--,4/28/2020,5/1/2020,5/3/2020 11:38,49,43,6,1
TX,4/18/2020,4/27/2020,5/3/2020 11:36,43,43,0,1
PA,4/21/2020,4/26/2020,5/3/2020 11:33,49,43,6,1
--,4/26/2020,4/28/2020,5/1/2020 10:48,43,43,0,1
GA,4/25/2020,4/27/2020,5/1/2020 10:47,44,45,-1,0
MI,4/28/2020,4/29/2020,5/1/2020 10:45,50,42,8,1
--,4/21/2020,4/28/2020,4/30/2020 16:35,49,45,4,1
--,4/27/2020,4/29/2020,4/30/2020 15:32,45,39,6,1
TX,4/27/2020,4/28/2020,4/30/2020 15:31,47,46,1,1
--,4/26/2020,4/28/2020,4/30/2020 15:30,47,41,6,1
NH,4/23/2020,4/27/2020,4/30/2020 15:27,50,42,8,1
UT,4/15/2020,4/21/2020,4/30/2020 15:25,32,51,-19,0
NC,4/13/2020,4/18/2020,4/30/2020 15:23,48,45,3,1
--,4/26/2020,4/28/2020,4/28/2020 22:00,44,40,4,1
NC,4/23/2020,4/26/2020,4/28/2020 21:53,50,45,5,1
--,4/23/2020,4/25/2020,4/28/2020 21:50,46,38,8,1
--,4/20/2020,4/26/2020,4/27/2020 17:57,46,42,4,1
--,4/21/2020,4/25/2020,4/27/2020 17:50,44,38,6,1
OH,4/20/2020,4/25/2020,4/27/2020 17:44,45,44,1,1
--,4/18/2020,4/25/2020,4/27/2020 17:41,52,44,8,1
NY,4/19/2020,4/23/2020,4/27/2020 17:40,65,29,36,1
--,4/16/2020,4/20/2020,4/27/2020 17:38,56,42,14,1
--,4/19/2020,4/19/2020,4/27/2020 17:36,49,40,9,1
TX,4/10/2020,4/19/2020,4/25/2020 1:43,44,49,-5,0
--,4/21/2020,4/21/2020,4/24/2020 23:57,54,44,10,1
NM,4/20/2020,4/21/2020,4/24/2020 23:53,52,40,12,1
PA,4/16/2020,4/18/2020,4/24/2020 23:45,47,47,0,1
WI,4/13/2020,4/15/2020,4/24/2020 23:43,50,45,5,1
MI,4/9/2020,4/11/2020,4/24/2020 23:42,49,43,6,1
--,4/23/2020,4/23/2020,4/24/2020 23:39,52,44,8,1
WI,4/20/2020,4/21/2020,4/23/2020 16:37,50,45,5,1
PA,4/20/2020,4/21/2020,4/23/2020 16:37,51,44,7,1
MI,4/20/2020,4/21/2020,4/23/2020 16:37,51,44,7,1
NC,4/20/2020,4/21/2020,4/23/2020 16:37,49,46,3,1
--,4/14/2020,4/21/2020,4/23/2020 16:34,53,44,9,1
PA,4/14/2020,4/20/2020,4/23/2020 16:31,48,42,6,1
NJ,4/16/2020,4/19/2020,4/23/2020 10:26,54,38,16,1
WI,4/15/2020,4/20/2020,4/23/2020 0:18,43,40,3,1
PA,4/15/2020,4/20/2020,4/23/2020 0:18,46,40,6,1
MI,4/15/2020,4/20/2020,4/23/2020 0:18,46,38,8,1
PA,4/18/2020,4/21/2020,4/22/2020 18:45,50,42,8,1
MI,4/18/2020,4/21/2020,4/22/2020 18:45,49,41,8,1
--,4/19/2020,4/21/2020,4/22/2020 14:17,48,42,6,1
FL,4/16/2020,4/20/2020,4/22/2020 14:15,46,42,4,1
--,4/17/2020,4/18/2020,4/22/2020 14:14,48,44,4,1
--,4/15/2020,4/21/2020,4/22/2020 1:04,47,39,8,1
--,4/13/2020,4/19/2020,4/21/2020 16:08,47,42,5,1
--,4/6/2020,4/12/2020,4/21/2020 16:08,45,42,3,1
--,4/16/2020,4/18/2020,4/21/2020 16:05,49,40,9,1
--,4/11/2020,4/18/2020,4/21/2020 16:03,52,44,8,1
MS,4/6/2020,4/9/2020,4/21/2020 16:01,38,49,-11,0
WA,3/31/2020,4/6/2020,4/21/2020 11:34,52,39,13,1
--,4/13/2020,4/15/2020,4/21/2020 11:30,49,42,7,1
IN,4/10/2020,4/13/2020,4/21/2020 11:29,39,52,-13,0
--,4/14/2020,4/16/2020,4/18/2020 19:47,53,47,6,1
--,4/14/2020,4/16/2020,4/18/2020 19:47,54,46,8,1
FL,4/14/2020,4/17/2020,4/18/2020 19:41,48,48,0,1
--,4/14/2020,4/16/2020,4/16/2020 22:34,46,42,4,1
NC,4/14/2020,4/15/2020,4/16/2020 22:33,48,47,1,1
--,4/13/2020,4/15/2020,4/16/2020 22:32,50,40,10,1
--,4/7/2020,4/14/2020,4/16/2020 22:28,54,42,12,1
--,4/8/2020,4/12/2020,4/16/2020 22:26,47,45,2,1
NC,4/5/2020,4/7/2020,4/15/2020 13:57,42,49,-7,0
--,4/12/2020,4/14/2020,4/15/2020 11:45,48,43,5,1
--,4/11/2020,4/14/2020,4/15/2020 11:43,48,44,4,1
--,4/13/2020,4/14/2020,4/14/2020 20:08,45,40,5,1
--,4/6/2020,4/10/2020,4/14/2020 15:43,49,45,4,1
VA,3/25/2020,4/8/2020,4/14/2020 9:18,51,41,10,1
CT,3/24/2020,4/3/2020,4/14/2020 8:17,48,34,14,1
AZ,4/7/2020,4/8/2020,4/14/2020 6:47,52,43,9,1
--,3/28/2020,4/4/2020,4/13/2020 15:36,50,44,6,1
--,3/21/2020,3/28/2020,4/13/2020 15:36,51,43,8,1
--,4/4/2020,4/10/2020,4/13/2020 14:46,53,43,10,1
MI,4/6/2020,4/8/2020,4/13/2020 14:10,50,41,9,1
WI,4/6/2020,4/8/2020,4/13/2020 14:10,48,47,1,1
--,4/3/2020,4/5/2020,4/13/2020 14:10,50,43,7,1
UT,3/21/2020,3/30/2020,4/13/2020 8:19,41,46,-5,0
--,3/10/2020,3/24/2020,4/11/2020 19:09,48,36,12,1
--,4/5/2020,4/7/2020,4/9/2020 18:21,42,42,0,1
--,2/4/2020,4/3/2020,4/9/2020 14:21,43,45,-2,0
--,4/6/2020,4/7/2020,4/9/2020 13:19,49,40,9,1
--,4/3/2020,4/6/2020,4/9/2020 11:03,53,42,11,1
--,4/3/2020,4/7/2020,4/9/2020 10:01,48,44,4,1
--,4/2/2020,4/6/2020,4/8/2020 14:02,49,41,8,1
--,4/3/2020,4/6/2020,4/8/2020 12:10,44,39,5,1
--,4/5/2020,4/7/2020,4/8/2020 10:02,48,42,6,1
--,4/6/2020,4/7/2020,4/8/2020 9:36,43,37,6,1
--,3/4/2020,4/3/2020,4/8/2020 9:04,45,40,5,1
--,3/30/2020,4/5/2020,4/7/2020 6:35,46,42,4,1
--,3/29/2020,4/1/2020,4/6/2020 16:49,47,41,6,1
FL,3/31/2020,4/4/2020,4/6/2020 6:09,46,40,6,1
MI,3/30/2020,4/1/2020,4/3/2020 19:35,46,46,0,1
GA,3/31/2020,4/1/2020,4/3/2020 11:04,46,48,-2,0
MI,3/31/2020,4/1/2020,4/2/2020 16:57,48,45,3,1
--,3/20/2020,3/24/2020,4/2/2020 10:49,50,41,9,1
--,3/26/2020,3/28/2020,4/1/2020 14:00,49,43,6,1
WI,3/24/2020,3/29/2020,4/1/2020 13:18,48,45,3,1
CA,3/28/2020,3/29/2020,4/1/2020 12:55,67,29,38,1
--,3/29/2020,3/31/2020,4/1/2020 9:28,46,42,4,1
--,3/26/2020,3/28/2020,4/1/2020 9:04,45,40,5,1
--,3/27/2020,3/30/2020,4/1/2020 6:06,47,43,4,1
--,3/30/2020,3/31/2020,3/31/2020 19:15,46,40,6,1
--,3/23/2020,3/29/2020,3/30/2020 18:38,46,42,4,1
--,3/24/2020,3/26/2020,3/30/2020 12:41,55,45,10,1
NY,3/22/2020,3/26/2020,3/30/2020 5:56,58,33,25,1
--,3/22/2020,3/25/2020,3/29/2020 0:05,50,44,6,1
--,3/22/2020,3/25/2020,3/29/2020 0:05,49,47,2,1
--,3/25/2020,3/26/2020,3/27/2020 19:59,46,40,6,1
--,3/21/2020,3/24/2020,3/27/2020 17:59,49,40,9,1
PA,3/19/2020,3/21/2020,3/27/2020 6:21,45,47,-2,0
WI,3/17/2020,3/19/2020,3/27/2020 6:20,45,49,-4,0
MI,3/12/2020,3/16/2020,3/27/2020 6:20,50,44,6,1
MI,3/17/2020,3/25/2020,3/26/2020 5:52,47,42,5,1
OH,3/17/2020,3/25/2020,3/26/2020 5:52,43,47,-4,0
PA,3/17/2020,3/25/2020,3/26/2020 5:52,45,47,-2,0
WI,3/17/2020,3/25/2020,3/26/2020 5:52,45,45,0,1
MI,3/16/2020,3/20/2020,3/25/2020 10:20,44,41,3,1
--,3/22/2020,3/24/2020,3/25/2020 9:08,46,42,4,1
--,3/18/2020,3/22/2020,3/24/2020 11:04,48,45,3,1
--,3/16/2020,3/22/2020,3/24/2020 6:14,47,42,5,1
--,3/5/2020,3/12/2020,3/19/2020 8:13,51,49,2,1
CT,2/24/2020,3/12/2020,3/19/2020 8:13,52,36,16,1
--,3/15/2020,3/17/2020,3/18/2020 9:40,48,41,7,1
--,3/13/2020,3/16/2020,3/17/2020 9:34,46,37,9,1
--,3/11/2020,3/15/2020,3/17/2020 5:56,48,42,6,1
FL,3/14/2020,3/16/2020,3/16/2020 22:57,45,45,0,1
--,3/13/2020,3/15/2020,3/16/2020 18:08,47,43,4,1
FL,3/6/2020,3/12/2020,3/16/2020 12:07,45,48,-3,0
AZ,3/10/2020,3/15/2020,3/16/2020 12:00,47,46,1,1
OH,3/10/2020,3/13/2020,3/16/2020 12:00,49,45,4,1
AZ,3/11/2020,3/14/2020,3/16/2020 6:56,46,43,3,1
--,3/11/2020,3/13/2020,3/15/2020 8:54,52,43,9,1
AZ,2/11/2020,2/15/2020,3/13/2020 17:16,42,46,-4,0
AZ,3/6/2020,3/11/2020,3/13/2020 9:58,50,42,8,1
AZ,3/3/2020,3/4/2020,3/13/2020 8:54,49,43,6,1
--,3/10/2020,3/11/2020,3/12/2020 16:45,45,41,4,1
--,3/8/2020,3/11/2020,3/12/2020 12:41,48,46,2,1
WI,3/10/2020,3/11/2020,3/12/2020 8:35,48,45,3,1
KS,3/10/2020,3/11/2020,3/12/2020 8:35,40,52,-12,0
IA,3/2/2020,3/6/2020,3/11/2020 20:43,41,51,-10,0
OK,3/5/2020,3/8/2020,3/11/2020 16:04,33,57,-24,0
--,3/8/2020,3/10/2020,3/11/2020 9:14,47,43,4,1
WA,3/4/2020,3/6/2020,3/10/2020 23:28,57,34,23,1
--,2/26/2020,2/28/2020,3/10/2020 13:40,55,45,10,1
--,3/6/2020,3/9/2020,3/10/2020 12:08,44,42,2,1
FL,3/5/2020,3/7/2020,3/10/2020 8:10,49,51,-2,0
--,3/5/2020,3/8/2020,3/10/2020 5:42,48,41,7,1
MI,3/7/2020,3/9/2020,3/9/2020 22:41,44,46,-2,0
--,3/5/2020,3/8/2020,3/9/2020 15:03,52,41,11,1
PA,3/6/2020,3/8/2020,3/9/2020 14:13,46,40,6,1
WI,3/6/2020,3/8/2020,3/9/2020 14:13,44,42,2,1
MI,3/6/2020,3/8/2020,3/9/2020 14:12,45,41,4,1
MI,3/5/2020,3/8/2020,3/9/2020 13:05,48,41,7,1
ND,3/3/2020,3/6/2020,3/9/2020 11:24,38,55,-17,0
MI,3/5/2020,3/7/2020,3/9/2020 8:49,44,46,-2,0
PA,3/5/2020,3/7/2020,3/9/2020 8:49,44,45,-1,0
WI,3/5/2020,3/7/2020,3/9/2020 8:49,43,45,-2,0
--,3/4/2020,3/7/2020,3/9/2020 7:16,53,43,10,1
MI,2/6/2020,2/18/2020,3/7/2020 0:26,43,43,0,1
PA,2/6/2020,2/18/2020,3/7/2020 0:26,47,42,5,1
WI,2/6/2020,2/18/2020,3/7/2020 0:26,42,44,-2,0
UT,2/24/2020,3/1/2020,3/6/2020 0:14,33,50,-17,0
MS,2/26/2020,2/28/2020,3/5/2020 8:16,41,56,-15,0
ME,3/2/2020,3/4/2020,3/5/2020 8:02,52,42,10,1
AZ,3/2/2020,3/4/2020,3/5/2020 8:02,48,47,1,1
GA,2/24/2020,3/2/2020,3/4/2020 6:59,43,51,-8,0
VA,2/25/2020,2/28/2020,3/3/2020 0:21,45,38,7,1
TX,2/24/2020,3/2/2020,3/2/2020 20:07,43,47,-4,0
CA,2/24/2020,3/2/2020,3/2/2020 17:43,62,26,36,1
CO,2/15/2020,2/19/2020,3/2/2020 15:49,46,43,3,1
NC,2/15/2020,2/19/2020,3/2/2020 15:47,46,44,2,1
FL,2/17/2020,2/22/2020,3/2/2020 14:11,51,40,11,1
--,2/17/2020,2/22/2020,3/2/2020 14:10,47,40,7,1
CA,2/26/2020,2/28/2020,3/2/2020 11:02,59,31,28,1
--,2/20/2020,2/29/2020,3/2/2020 9:29,49,46,3,1
NC,2/27/2020,2/28/2020,3/1/2020 9:39,48,46,2,1
NC,2/23/2020,2/27/2020,3/1/2020 8:59,49,45,4,1
TX,2/23/2020,2/27/2020,3/1/2020 8:59,45,49,-4,0
TX,2/17/2020,2/26/2020,3/1/2020 6:06,44,45,-1,0
MO,2/26/2020,2/27/2020,2/29/2020 10:06,42,52,-10,0
SC,2/25/2020,2/28/2020,2/28/2020 18:55,42,48,-6,0
--,2/23/2020,2/27/2020,2/28/2020 15:26,46,42,4,1
--,2/26/2020,2/27/2020,2/28/2020 14:44,50,41,9,1
CA,2/20/2020,2/25/2020,2/28/2020 14:34,60,31,29,1
TX,2/22/2020,2/26/2020,2/28/2020 12:14,48,47,1,1
CA,2/22/2020,2/26/2020,2/28/2020 12:13,60,35,25,1
TX,2/21/2020,2/26/2020,2/28/2020 12:03,43,46,-3,0
--,2/23/2020,2/26/2020,2/27/2020 18:14,49,41,8,1
WI,2/19/2020,2/23/2020,2/27/2020 13:47,46,46,0,1
NH,2/19/2020,2/25/2020,2/27/2020 10:55,44,46,-2,0
PA,2/12/2020,2/20/2020,2/27/2020 7:06,47,47,0,1
MT,2/12/2020,2/22/2020,2/26/2020 20:33,34,56,-22,0
--,2/19/2020,2/25/2020,2/26/2020 10:57,47,40,7,1
MD,2/13/2020,2/19/2020,2/25/2020 0:04,60,35,25,1
VA,2/9/2020,2/18/2020,2/24/2020 9:47,48,40,8,1
NY,2/16/2020,2/20/2020,2/24/2020 6:46,55,36,19,1
--,2/20/2020,2/22/2020,2/23/2020 10:39,47,45,2,1
PA,2/11/2020,2/20/2020,2/23/2020 8:20,46,45,1,1
MI,2/11/2020,2/20/2020,2/23/2020 8:20,47,43,4,1
WI,2/11/2020,2/20/2020,2/23/2020 8:20,45,43,2,1
NV,2/19/2020,2/21/2020,2/21/2020 16:04,44,41,3,1
CA,1/2/2020,2/15/2020,2/20/2020 16:15,60,30,30,1
MI,2/12/2020,2/18/2020,2/20/2020 12:05,47,43,4,1
PA,2/12/2020,2/18/2020,2/20/2020 12:05,50,42,8,1
WI,2/12/2020,2/18/2020,2/20/2020 12:05,42,49,-7,0
FL,2/10/2020,2/18/2020,2/19/2020 22:16,49,48,1,1
CA,2/13/2020,2/16/2020,2/19/2020 17:54,57,37,20,1
NC,2/13/2020,2/16/2020,2/19/2020 17:46,49,45,4,1
--,2/13/2020,2/17/2020,2/19/2020 10:25,48,45,3,1
--,2/14/2020,2/17/2020,2/19/2020 9:30,42,40,2,1
--,2/14/2020,2/17/2020,2/19/2020 6:05,52,45,7,1
--,2/14/2020,2/17/2020,2/19/2020 6:04,52,44,8,1
--,2/12/2020,2/17/2020,2/19/2020 5:04,45,43,2,1
--,2/14/2020,2/17/2020,2/18/2020 16:59,52,44,8,1
NJ,2/12/2020,2/16/2020,2/18/2020 16:50,52,34,18,1
OK,2/10/2020,2/13/2020,2/18/2020 11:56,33,57,-24,0
--,2/13/2020,2/16/2020,2/18/2020 4:58,50,44,6,1
--,2/4/2020,2/9/2020,2/11/2020 8:29,45,42,3,1
NH,2/8/2020,2/10/2020,2/10/2020 22:24,44,46,-2,0
--,2/7/2020,2/10/2020,2/10/2020 18:40,44,42,2,1
--,2/5/2020,2/9/2020,2/10/2020 14:17,50,43,7,1
--,1/27/2020,2/2/2020,2/2/2020 14:30,46,42,4,1
--,1/26/2020,1/29/2020,2/2/2020 13:10,50,44,6,1
GA,2/1/2020,2/1/2020,2/2/2020 7:20,44,51,-7,0
GA,2/1/2020,2/1/2020,2/2/2020 7:20,47,43,4,1
--,1/15/2020,1/28/2020,1/31/2020 13:10,49,40,9,1
--,1/20/2020,1/23/2020,1/27/2020 8:00,50,46,4,1
--,1/19/2020,1/22/2020,1/24/2020 8:00,50,41,9,1
--,1/16/2020,1/19/2020,1/20/2020 8:00,53,44,9,1
--,1/6/2020,1/12/2020,1/14/2020 14:30,46,41,5,1
--,1/1/2020,1/1/2020,1/1/2020 8:00,48,41,7,1
--,1/1/2020,1/1/2020,1/1/2020 8:00,51,42,9,1
